"sex","age","Computer","TV","Cellphone","Software","Frequency3","Monetary3","Monetary60"
1,37,4,1,0,2,7,1607621.20656276,3220018.16223884
0,21,4,1,1,1,7,1654844.15638362,4792483.9219101
1,20,1,2,2,1,6,1884846.00667655,4681646.22619232
1,11,0,3,0,2,5,1415477.82762533,5861252.14096508
1,17,0,2,1,0,3,1669847.83548436,3914120.7031048
1,33,3,2,2,0,7,1545481.23852585,4947146.20356515
0,31,0,3,2,5,10,2105460.07100934,6473999.40880908
0,28,0,2,1,6,9,1489749.89392392,5644315.25812264
0,19,1,2,2,7,12,2778741.22300153,9471111.08747988
0,31,6,3,0,6,15,2918166.52414713,2283950.86912228
1,33,4,1,1,4,10,1911474.13364375,8608557.63662782
0,36,1,0,1,4,6,1716291.01120753,4166897.98554586
0,27,3,1,1,1,6,1911924.39250468,6218210.68884069
0,23,3,2,1,5,11,1850448.16849163,5158172.7268641
0,19,3,3,2,3,11,2524179.00577484,5134171.76140403
0,19,2,3,2,3,10,1747747.81068215,3291324.07951625
1,20,1,2,1,0,4,1568031.30474543,6070611.82135888
0,29,5,0,0,0,5,1790373.64486958,5269906.87978666
0,17,6,0,1,2,9,1539423.47205208,8443664.04702361
0,36,4,0,2,3,9,2121702.25139448,5381559.82334991
0,33,2,2,0,1,5,1488341.60756072,2662927.73792025
0,38,1,0,1,3,5,1726595.31124986,4509869.94814665
0,35,3,0,1,6,10,2009719.62158691,5975292.98210651
1,39,1,2,1,2,6,1693040.77533858,4275894.58805015
1,12,5,2,2,3,12,2238082.32891766,4644384.43695317
1,16,1,1,2,0,4,1418756.31018427,5007130.17063102
1,27,2,1,0,7,10,2513800.70450599,7209767.24199719
1,15,6,2,0,2,10,2478641.08107034,3995479.3939677
0,26,2,3,0,7,12,1799346.90910439,7364052.09843967
0,10,2,3,0,6,11,2193621.02127869,7036727.56528637
1,32,1,2,0,6,9,2213679.71941111,11995036.1560213
0,14,5,0,1,6,12,1986771.36833141,6187846.98372104
1,20,2,2,0,6,10,1816478.95948774,2883466.60180076
1,36,6,2,2,1,11,1827785.81633099,8377068.62410562
1,39,5,1,1,0,7,1686633.70012897,8556420.19599449
1,29,4,3,1,1,9,2351936.64047826,5801695.11671109
0,25,1,0,0,5,6,1078031.31930185,4894854.61631521
0,36,0,3,2,0,5,1208609.01373452,4613707.3725853
1,40,2,1,2,6,11,1601958.92879187,4648801.81159805
0,17,5,2,1,7,15,2349641.19961997,9370538.63716474
0,24,0,0,2,2,4,1368722.134035,3857336.39343777
0,39,4,3,2,1,10,1632321.16220332,2785261.18662458
0,16,1,0,0,6,7,2061339.93938262,3590067.30986512
1,24,3,2,1,0,6,1500226.89287127,4810279.90244606
1,36,0,2,1,4,7,1666278.10344668,5075364.38810938
1,22,2,3,1,2,8,2120843.30590766,5621061.60847736
0,34,5,3,2,4,14,2197878.4687344,4751482.55047325
0,29,5,2,0,1,8,2003868.24765226,5370991.00685036
0,39,2,0,2,7,11,2896951.21626092,7408193.28523212
1,30,5,2,0,6,13,1722693.52212886,6151385.61247538
0,22,3,2,2,5,12,1970098.65463045,9303252.90231594
0,38,5,1,1,7,14,1701334.89226567,8871245.60574031
0,23,0,0,2,5,7,1752469.47854927,3599335.20455776
0,38,5,1,0,7,13,1669160.86653373,3736567.60250173
1,26,3,2,2,6,13,2760970.09548374,6011270.88564221
0,31,0,2,0,7,9,2047832.95376096,8055926.44799169
0,33,6,3,1,3,13,2604499.37896494,4958875.43373053
0,11,6,0,0,5,11,1484695.91040987,8190188.53397534
0,40,4,3,2,7,16,2822925.89447133,8014635.61568015
0,23,1,2,1,7,11,1954696.46753781,7212393.27334233
1,19,1,1,0,6,8,1993854.31376323,5972298.75752649
0,28,0,3,0,0,3,1135011.03916378,4490353.6442843
0,39,1,0,1,7,9,1662954.80804964,5563821.20820005
0,16,2,0,1,3,6,2004691.09420333,3877873.5579436
0,20,5,0,1,6,12,2447487.57029536,11720937.8257327
1,38,6,3,1,1,11,1829489.5218816,7269549.71416939
0,38,3,3,0,5,11,1967651.15405923,7745848.26167466
0,40,0,1,2,5,8,2082375.86838615,6614601.57106029
1,18,1,2,0,6,9,2613495.52034119,8111380.60941518
1,17,6,1,1,5,13,2389184.22117153,8243145.58486059
1,14,0,0,2,6,8,2325642.68268831,7572783.47606348
1,31,1,2,2,6,11,1688344.76978996,7201213.05903665
0,39,6,2,0,2,10,1969591.92265568,5717903.51093974
1,13,4,2,1,5,12,2249209.78339978,5785191.0165117
1,10,2,2,2,0,6,1665478.79445464,4509119.23692665
0,23,2,3,0,3,8,1942539.31160016,5073921.22652598
1,19,2,3,0,4,9,2508268.92971054,5662379.64079492
0,30,6,3,2,0,11,2116936.73939109,4954155.93756701
1,36,2,3,2,0,7,1850380.13841235,6174984.47610212
1,13,1,2,2,1,6,1637195.44153557,4112908.34208396
1,37,5,3,2,4,14,3191091.62503795,8534058.04236687
0,33,0,1,0,3,4,1264111.98583112,2813580.38552091
0,11,6,3,1,7,17,2528482.55398381,12919955.9439743
0,10,1,3,0,2,6,1188805.68934259,4513720.69996627
0,18,6,2,1,6,15,3364342.92466724,8380114.80961107
0,17,5,1,1,7,14,2117116.61515564,4998813.65874386
0,32,1,2,0,5,8,2089424.41445831,3251003.67420654
0,39,5,0,1,1,7,2102796.04018719,7165349.08421999
0,22,2,0,1,6,9,1904847.5839189,7652031.88418359
0,20,6,2,0,3,11,1896314.04315695,6785828.93580513
0,14,4,3,2,5,14,2710776.74580872,8574601.82912454
0,19,4,0,2,6,12,1725445.73047199,7361092.26016124
0,17,1,0,0,7,8,2233738.31700916,8019173.27396934
0,10,6,0,1,0,7,1430679.66844427,8336784.17088382
1,13,0,3,0,1,4,1207921.53733451,4071861.932034
0,26,5,1,1,2,9,2151319.02101117,9296225.07785995
0,25,3,2,1,6,12,2370954.14369116,5714872.23126001
0,31,5,1,2,5,13,2801700.79041982,6915799.3532081
0,29,1,2,0,1,4,1142064.01631007,5339859.70258657
0,17,4,2,2,6,14,1844910.53636923,6255325.25109339
1,31,2,3,0,2,7,1285690.00453099,3819100.06183025
0,23,1,3,1,5,10,2060101.07911802,5266009.44704537
1,25,5,1,2,4,12,2131507.5275187,6819827.03497156
0,35,2,1,2,4,9,2402424.15062378,4389670.22726905
0,15,4,1,0,6,11,2188196.48402925,9295590.16940288
0,15,1,3,2,1,7,2191587.46017344,7141477.04429811
0,33,3,0,0,0,3,942771.003782036,5363833.47894686
0,26,5,0,1,7,13,2144809.82910202,5007746.65565355
0,30,1,2,0,0,3,1012596.47891822,3276277.07975809
0,31,0,0,1,5,6,2187835.4056427,7610110.78978294
1,33,6,2,1,3,12,2437297.3194499,8701473.45053335
1,21,5,1,2,6,14,1876446.08621251,5731363.97989915
0,19,5,1,0,0,6,1956393.39264845,6154708.98366256
1,17,4,2,2,5,13,1773736.7026634,9966398.39366848
0,22,4,3,2,4,13,1585346.14672821,5199931.23735918
0,26,1,2,1,3,7,1962003.36827255,6725526.35601099
0,15,1,0,0,1,2,919136.735949068,3243380.46079686
0,40,5,0,2,1,8,1977392.84765237,5489911.1393818
0,16,1,1,1,7,10,2071514.70621979,3584481.93422042
1,14,4,3,2,7,16,2830868.95941199,7482579.71344215
0,32,0,2,0,6,8,2129578.1394292,3746518.52667818
0,37,3,1,2,6,12,2265013.9597828,4937884.12002318
0,34,2,2,0,4,8,1429669.32706177,1572267.11137491
0,19,4,3,1,4,12,2074028.54430219,5438535.29362702
0,38,6,2,0,2,10,1788048.08698537,8500616.39821974
0,34,2,3,1,3,9,1395010.1449231,7694107.61579238
0,10,6,1,1,0,8,1915601.456093,6635944.09845778
1,36,3,2,1,4,10,1997857.60987423,6280991.75411767
1,12,5,3,0,7,15,3045849.01295742,8545570.03169252
0,33,0,0,0,3,3,1758805.6050511,3899191.1275431
0,10,6,1,2,3,12,2286622.91650015,7333023.06587212
0,15,5,2,1,4,12,2615274.57884537,6275622.1037161
0,13,5,3,0,7,15,1879326.45641621,12757676.0017526
1,35,5,2,2,4,13,1586814.1067801,5253360.18884774
0,30,6,1,2,0,9,1718291.10463554,3152680.43973981
0,37,6,1,0,3,10,2236805.62597808,7223267.02160485
1,30,2,3,2,7,14,1400935.24995328,10132199.3561089
1,21,2,0,2,4,8,1310651.92633778,6592823.6499916
0,10,1,0,0,6,7,1550270.04052578,5266253.96652205
1,36,0,0,1,1,2,1033490.19649947,2573856.19757456
1,30,3,3,2,3,11,2170811.20790055,6831367.46880021
1,35,0,1,1,0,2,1375454.72920899,4494336.90506352
0,19,5,2,2,2,11,2610219.79712422,6063172.75314777
1,40,5,3,1,7,16,2295034.00628411,9715974.46232592
1,28,0,3,1,2,6,1678508.95821486,6494474.94564566
1,29,4,2,2,7,15,1416065.84267661,7985537.07108641
0,25,3,1,1,4,9,1668722.2632745,6437111.16188939
0,27,0,2,1,5,8,1556508.31792934,7263256.13242075
0,11,2,0,1,5,8,1957285.59684054,5882404.64023608
0,11,1,2,2,6,11,2207049.71198289,9014337.50425973
0,16,3,0,1,3,7,1665925.1815273,2479277.74340725
0,38,1,2,2,3,8,1827961.76630575,4930731.80249985
0,33,3,2,2,2,9,1974134.5756586,4293319.97948806
0,24,6,1,2,2,11,2313146.74127457,5327248.08489176
0,30,2,3,0,5,10,1711772.69185263,6275868.51452945
0,38,3,3,2,6,14,2915964.11436282,7689439.68064965
0,28,6,1,2,2,11,3090056.54067245,4765922.29029686
0,35,6,3,1,6,16,2744841.93946232,6541218.48860482
0,21,1,1,0,0,2,969176.349118354,4764909.50345581
1,13,3,1,2,6,12,1954954.16469379,4532933.35434793
1,17,4,1,1,2,8,1407829.79108179,4998644.38144042
1,22,6,1,1,7,15,3089040.79967001,4637633.95646437
1,11,1,0,2,5,8,1756435.80055624,5985817.74489514
0,14,0,0,2,7,9,1630231.30056556,4460459.75497922
0,34,0,3,0,7,10,2203517.28087956,7167328.33033713
0,21,4,3,0,3,10,2156077.44370273,3068799.76681256
0,30,4,1,1,0,6,1567131.23957188,3520195.33031492
0,19,1,0,0,6,7,2179850.17670474,3163137.11716413
1,21,4,3,1,5,13,2206977.66296809,5908231.94082146
1,17,0,0,2,6,8,1504204.1662264,6268148.68637156
0,20,5,1,1,0,7,1538017.07437507,1989601.64692844
0,36,2,1,1,4,8,1809988.62309599,7891100.57393557
1,32,1,1,2,6,10,2217801.26547347,4293162.32735302
1,11,5,1,2,6,14,2668675.94547461,5732893.12889735
0,28,4,0,0,3,7,1517683.36675813,2259579.30931039
1,11,1,0,0,0,1,885736.508878959,5837035.0929291
1,21,3,1,1,1,6,1799286.91674709,7017892.07557686
0,31,4,2,2,1,9,2154640.5046846,4524077.41730356
0,14,5,1,2,2,10,1762884.5240298,3986778.63747041
0,34,5,0,2,1,8,1692136.70532012,4610666.63434919
1,20,2,0,1,3,6,1518778.34333824,4108456.00116387
0,36,4,2,1,0,7,1861152.46558065,5288424.20481687
0,35,5,0,2,2,9,1825649.49812556,5677421.3675628
0,20,6,2,1,7,16,2365876.64208286,8776842.5690817
1,24,0,2,2,3,7,1921329.29896573,5214368.81836592
0,40,6,0,2,3,11,2696845.21383424,6377562.3809963
0,22,2,2,1,6,11,2492927.00773904,4438637.3762729
0,27,4,3,0,7,14,2054395.80344971,7761878.06541419
0,13,4,1,0,1,6,1735795.56816104,4588820.9998876
1,12,3,3,1,0,7,1828403.73234935,5771994.44295773
1,36,1,1,2,6,10,1904583.56220256,7026316.42267586
1,21,1,3,0,0,4,1465633.44218948,3826764.7511788
1,19,6,0,0,1,7,1569610.55472973,5405513.21694394
1,31,5,2,2,3,12,1271532.22941593,6141902.00551531
0,10,1,1,2,6,10,1910269.2557354,3488938.04278823
1,34,6,3,0,0,9,1829060.76424532,5611149.69805276
1,17,2,0,2,3,7,1985616.19715833,3888171.59415259
0,27,1,2,1,5,9,1884168.64972955,4409350.26635622
0,40,6,2,2,0,10,1996876.22104953,6261212.43535906
1,14,5,2,0,4,11,1850860.85197431,5183167.39641506
0,34,0,0,0,6,6,1892670.71942524,6052832.33128562
0,34,2,1,1,1,5,1081830.35616708,2695322.65443209
0,29,0,3,1,5,9,2067474.39364458,6993686.53733631
1,26,4,3,1,4,12,2442206.0218203,5677503.12980324
0,33,2,0,1,3,6,1695646.43152319,4319984.66909178
0,29,3,1,0,3,7,2150394.32674097,3870261.31474558
0,10,1,0,2,4,7,1603087.9959338,4547417.19374328
0,22,4,0,1,7,12,2173682.10462127,9429492.28520667
0,39,5,2,1,0,8,1837153.61703734,5310603.36733851
1,39,6,2,1,5,14,2066458.28329855,10741582.5686232
0,34,3,2,2,3,10,2327416.54691856,7423730.75269443
0,29,1,2,0,5,8,1748656.77871975,6650798.79448455
0,36,1,2,0,1,4,1593310.76068109,1972147.93425307
0,22,6,0,1,5,12,2143756.24433439,6881681.50859199
0,17,4,2,2,5,13,1287303.00273966,5857298.50129523
0,34,6,3,1,2,12,1554164.87039083,5873052.00294491
0,35,4,3,1,3,11,2305067.8437863,4183583.32785947
1,31,2,1,2,5,10,1226597.61672233,6360087.28479668
0,25,4,0,2,7,13,2922943.81328275,8072941.28861884
0,38,4,1,1,5,11,2818592.71326067,6915789.80572304
0,19,4,0,2,6,12,2559843.25684376,6729463.21536229
0,39,3,0,1,2,6,1996936.79298087,7211527.81072097
0,36,5,2,2,1,10,2185487.81079959,8609754.80663558
1,25,6,0,2,0,8,1927503.93640827,2010437.53459914
0,33,5,3,1,5,14,2332424.54325167,7674135.14661169
0,21,4,1,0,3,8,1776803.61625966,2307465.58070651
0,29,4,3,1,0,8,2262247.0894955,6087226.57393181
0,13,5,3,0,6,14,1840371.24604342,5803669.16022103
0,10,4,2,1,6,13,2404885.44174566,3480060.38900691
0,31,0,3,0,6,9,2083413.15046329,5164528.8917761
1,20,0,3,0,3,6,1541484.73536354,2593539.13405616
0,27,1,0,1,3,5,1287078.89721677,5038891.16092399
0,17,4,3,1,6,14,2363713.21962926,6518287.97175235
0,28,3,0,1,5,9,1422790.74773237,3905204.02536577
0,19,6,1,1,5,13,2425089.51635322,4451462.38426745
0,34,3,1,2,5,11,1794412.31898614,4531581.28411763
0,29,3,0,2,7,12,2206718.79232186,5364871.66016614
1,29,3,0,1,2,6,1707229.32426965,6276903.6525455
0,26,3,3,1,3,10,2553542.59641442,2628950.65331615
1,36,4,3,1,0,8,2100907.03574842,5038696.86278485
1,21,0,2,0,0,2,1156087.96937034,2855766.56484943
0,39,5,3,2,6,16,1980860.27011897,9060410.59185095
1,39,2,0,1,1,4,1422132.35517172,4581054.0821822
0,29,6,3,2,0,11,2005814.90351207,9426145.34631427
0,30,2,2,0,7,11,1995756.73546998,6455576.82383441
0,39,5,2,0,7,14,2109546.13123587,10047540.8113361
0,19,6,1,2,5,14,2147802.25142774,12528343.4330631
0,32,2,0,0,2,4,966638.97959685,2759715.00682497
0,12,0,0,1,4,5,1900875.43156465,3639187.20100313
1,37,2,3,1,7,13,2008011.97438146,6357352.32586969
0,32,6,2,0,4,12,2645618.63797931,8005592.09152794
0,35,5,3,1,7,16,2815181.78343509,7258573.78460782
1,16,0,2,0,1,3,1191377.82443315,4748259.47369412
0,11,2,0,0,2,4,1441018.60697775,4457658.93320685
1,14,6,0,0,5,11,1569778.53660416,6003750.81368772
0,30,6,0,0,5,11,1746293.53212128,4012266.93428746
1,10,4,2,0,1,7,2092691.22039561,4623625.48261552
1,19,0,2,1,0,3,1159689.80754992,1595941.24402077
0,23,6,3,1,2,12,2240652.82639416,10910371.3436674
1,19,2,0,0,5,7,1208372.09737096,3618415.36984826
1,34,1,1,1,1,4,1298182.08522796,1914941.0264052
0,20,4,0,1,1,6,1360793.67621405,5098671.57218312
0,23,5,1,2,0,8,1933802.61941482,2129062.74683748
0,34,1,1,1,4,7,2013612.52500476,5743905.32190239
0,19,2,0,2,7,11,2252662.76670045,5617605.23481909
1,19,3,3,0,7,13,2386003.57691454,10532494.2318032
1,21,6,3,0,6,15,3044528.46057163,7516650.74689983
0,20,3,1,1,6,11,2786724.24379402,8720200.25519519
0,29,3,2,2,0,7,2123911.60442485,2437629.99869836
1,25,3,1,0,1,5,1440488.47020224,5245556.21676491
0,40,4,0,1,2,7,1753092.14733604,7000362.17620692
0,40,6,3,0,1,10,1230800.88788899,4995895.52507782
1,15,1,0,1,1,3,1557386.2836857,5065594.87153093
0,34,3,1,2,4,10,2240963.19694348,6136928.36856194
0,15,0,3,1,4,8,1732276.31387988,7672648.26220807
0,30,5,1,1,7,14,2320357.67664897,5994407.75167897
0,22,3,3,1,1,8,1951775.75581306,5807527.27760035
1,10,6,3,1,6,16,2578603.73797588,9271829.53232886
0,25,0,2,1,6,9,1657470.31804648,6013846.45746931
1,28,0,1,1,1,3,1812160.07951053,3698740.28711981
0,32,2,2,1,7,12,2200310.8188196,7998557.29562019
1,24,3,0,2,0,5,1610665.58181997,5260050.11342648
0,22,0,2,0,3,5,1547690.11125594,3891526.81886953
0,26,2,0,0,7,9,2046181.10765007,5726282.56739678
0,31,3,0,1,4,8,1751679.27104933,3082102.23087789
0,15,0,1,2,5,8,2263507.48268554,3583904.3294865
1,19,4,1,1,6,12,1945801.78597341,5147734.07962797
0,38,0,1,2,6,9,2192249.96891116,2400158.87824318
0,37,2,3,1,7,13,2358119.23296297,7165975.49227556
1,40,6,0,1,4,11,1506450.0326642,5793801.86276803
1,11,0,3,0,1,4,962361.691701474,3201024.68968114
1,32,6,2,1,5,14,2234964.21813432,7144922.50127391
0,36,1,1,0,1,3,1420577.79369748,6496484.76040691
1,11,2,3,0,6,11,2152718.29426618,6309837.37512722
1,17,0,1,0,3,4,1513044.35484564,561255.733187265
0,25,0,3,1,0,4,1488120.24076893,4200355.15947024
0,18,3,0,2,4,9,2374447.93610095,2799693.72499519
1,33,2,2,0,6,10,1644560.44536793,6354091.26780376
1,15,2,1,0,6,9,1416592.23331605,4577717.18034624
0,21,5,2,2,0,9,1970757.43240767,10145848.148793
0,30,1,3,0,7,11,1759337.17896397,5556591.97914473
0,15,4,0,1,3,8,2378030.7856881,6864626.98156267
1,37,0,1,1,4,6,1629011.95065635,3138018.36195108
1,27,6,3,0,7,16,2331463.54411702,9188660.25709247
0,18,6,0,1,7,14,1912266.75009592,10999605.4756312
0,19,2,3,1,4,10,1950250.23326692,5790060.10729317
0,16,3,0,2,4,9,2020213.58625986,3539467.99973134
1,17,2,3,0,0,5,1339723.13079572,4614463.43570688
0,20,0,2,2,3,7,1519899.09121396,2814376.40254992
1,27,0,1,0,0,1,1151555.76278153,2561196.44031366
0,22,2,3,1,4,10,1354905.47885327,9615925.63505326
0,39,6,3,0,4,13,1383969.60172622,8415458.08378204
0,21,5,0,0,4,9,2055783.99209447,8497417.90752945
0,30,4,0,1,1,6,1479551.24504975,6532154.80526309
0,39,5,0,0,0,5,1357085.72590292,1440887.52538334
0,38,4,3,2,2,11,2277090.20454874,4355525.69907331
0,21,2,2,1,0,5,1901673.57556366,6483813.77318088
0,17,5,0,2,1,8,2101664.11969332,1749904.27743914
0,23,5,1,1,5,12,2238726.83669599,8101053.17355268
1,21,6,1,1,1,9,2173127.52855485,2824903.53858138
0,38,1,0,1,7,9,1979356.6601904,7040963.4726504
1,30,2,3,0,2,7,1474943.48676964,3715606.01218396
0,28,6,1,2,6,15,2388558.44478203,5450774.23776827
0,30,4,0,2,3,9,1508746.17243619,6954813.63103733
1,31,5,1,1,7,14,2662762.86087444,9955802.42412635
0,10,3,0,0,0,3,1523856.50136349,4561857.80893708
0,32,4,2,0,5,11,2416885.0823048,6136208.77401452
1,23,5,3,1,4,13,3053586.64475154,7432203.86950905
0,34,1,1,1,6,9,1901053.99845266,6691974.69830762
0,38,6,1,2,6,15,1892486.51989431,4105052.46952898
0,19,6,1,1,5,13,2403841.35561974,6110892.33178003
0,36,5,0,1,5,11,2278312.95229182,1979977.00998477
0,23,4,0,1,4,9,2032460.08118224,4418018.62477574
0,21,6,0,0,0,6,1300214.26804319,4884950.99548542
0,31,6,0,2,7,15,2471792.01931885,8921720.10717764
0,22,4,2,0,1,7,1359082.79013292,6040187.49650731
0,37,5,0,0,2,7,1931414.09837258,6486664.35627611
0,30,4,2,0,7,13,2490117.33605955,9968966.15191144
0,15,4,0,1,5,10,2059697.57855604,4038454.05016145
1,27,6,1,2,6,15,1482050.75967501,6169674.20105147
0,32,1,2,0,2,5,1909484.17388246,4222203.00562773
0,14,3,1,0,0,4,1745102.66148767,4143061.11470999
0,21,5,0,0,0,5,1907404.82027025,5039998.94550283
1,40,5,0,0,4,9,2506871.93952698,6745060.20897762
0,13,0,3,2,5,10,1977853.07350601,6211134.4108377
0,39,2,2,0,5,9,1660984.29378554,5619185.27478268
0,12,0,2,0,0,2,1174988.86283201,4596582.61892149
1,33,0,3,0,7,10,1489541.49136166,5042116.03404927
1,28,1,1,0,4,6,1308463.46265325,5302608.27965422
1,17,1,3,1,3,8,1781286.48793937,5401748.17233313
1,31,1,0,1,6,8,1575869.2739517,6864268.77440411
0,24,6,1,1,3,11,2675892.64068657,7497815.40369167
0,39,3,3,2,5,13,2016978.46281201,9605300.06496051
0,28,3,0,2,6,11,1712851.61230727,7889094.78040608
0,27,1,0,0,1,2,1122242.27982138,3699105.08099948
0,32,5,0,1,5,11,2010731.62035554,5658848.18612409
0,33,5,2,1,5,13,2245538.36635228,10527568.2691134
1,17,5,2,0,0,7,2182448.25612825,2232945.80051589
0,10,2,1,0,5,8,1893529.31236651,4088514.38432843
0,27,2,2,1,4,9,1495409.64414445,5943050.8800672
1,28,1,0,0,7,8,1995339.58427249,8327399.19802966
1,31,5,3,0,3,11,2091073.27102283,2837755.3267403
0,29,4,2,0,1,7,2208117.69520024,6953342.42286791
1,31,3,1,0,7,11,1578348.90604333,8175584.80274579
1,31,0,0,2,0,2,1024674.45221119,2870796.99617038
1,19,5,2,0,3,10,1677657.55616334,9041937.87125384
1,21,2,2,1,5,10,1905840.49666144,4519861.63064599
0,11,4,1,1,5,11,2580238.42478468,9376454.95961767
1,23,2,1,0,2,5,1618195.65512478,4686745.65685221
0,19,1,0,0,7,8,1963632.76958548,4300260.52913303
0,40,2,1,1,6,10,2306307.51788274,5506197.66429036
0,28,5,1,1,3,10,1877866.79727805,5399521.40797589
0,20,0,3,0,0,3,1458610.25755123,3246931.8937302
0,31,2,1,1,6,10,1589986.26482867,6299176.30087964
0,25,2,2,1,3,8,1692006.15499432,5313305.17743401
0,29,6,0,1,5,12,2020338.54616822,4500727.81307484
0,25,6,1,2,5,14,2428852.2783132,4502636.53279982
1,37,3,3,2,1,9,1770231.70992025,3289123.75237585
1,20,4,0,1,4,9,1719339.01301834,4264140.69957521
0,16,4,1,2,3,10,1494367.29813702,6148812.04066381
0,20,2,0,1,5,8,1921869.60443598,4828378.91492269
1,19,2,2,1,0,5,1953321.73367256,5948617.5733897
0,10,4,2,2,4,12,2406103.29503392,8937147.2913238
1,30,1,3,1,1,6,1092952.49079982,4574203.43085519
0,18,0,3,0,5,8,1993981.53666003,7072986.0557261
1,11,0,2,0,7,9,1313796.96762616,3527627.18058651
0,30,0,2,2,4,8,1841484.11980351,5949591.54953943
0,14,5,3,0,0,8,1855508.58439308,6066621.76642104
0,39,4,2,1,0,7,1860834.7566417,2516416.08979715
0,16,3,0,1,5,9,2085012.15776763,4933132.28646776
0,11,5,0,0,3,8,2162123.86854691,4754724.1531911
0,35,3,3,0,4,10,1935998.62547113,5686893.56800952
0,13,2,2,0,2,6,952545.715364257,4432373.70891777
0,14,2,0,1,5,8,1309813.82559637,5783752.86251502
0,15,5,1,2,0,8,1787171.14259396,5235418.63898924
1,36,4,2,2,3,11,2029639.0195989,4892362.81198981
0,22,6,3,0,7,16,2511180.04133246,6678556.5157596
0,34,5,1,2,0,8,1882269.71732833,3010750.94600699
1,34,3,2,0,1,6,1821794.96539576,8509857.96826931
0,34,5,0,0,7,12,2336165.22977712,5805667.13470635
1,12,6,2,1,1,10,1782869.02063613,4637163.6149338
0,23,6,2,2,2,12,1338907.88628962,5959798.4079046
0,15,5,0,0,0,5,1285921.93345488,2901309.19837017
1,31,0,0,0,5,5,1521567.80031872,3575601.39157165
1,15,2,2,0,0,4,1351471.02860261,4974076.4773345
0,28,0,2,1,2,5,1314268.94688486,5266581.77754624
0,14,4,1,0,0,5,1784872.37856088,7893830.2140103
0,26,0,3,1,5,9,2508425.20665886,8204558.6483271
0,28,4,0,2,1,7,1935458.01342763,6525777.38467185
0,26,1,0,1,2,4,1618859.69844698,4383800.57506792
0,29,0,2,0,2,4,1540013.09609714,5755137.56654593
1,30,1,1,1,4,7,1814729.7489764,5513723.95998542
0,38,0,3,1,6,10,1844795.55186766,6260614.00560201
0,16,3,0,1,3,7,1967913.26192574,6280145.42780666
0,29,2,3,0,0,5,1568857.42995044,4025213.89329965
0,17,0,2,1,3,6,1639559.42346369,4905701.04428661
0,35,4,2,1,0,7,1697295.33583838,6257996.34166864
0,22,3,1,2,7,13,1892405.20220668,6508109.26821646
0,40,1,0,1,3,5,1355196.23857201,5159825.51836969
0,23,1,2,1,0,4,1422185.64055648,5296876.93412599
0,38,5,3,1,7,16,2020986.11012674,9956902.44214798
0,31,6,3,0,1,10,1776593.00788465,6211398.16954475
0,10,1,2,0,1,4,1269099.05404549,2946659.50761869
1,19,6,1,2,7,16,2765564.49813933,6045831.07699591
1,23,1,3,1,1,6,1760625.2396157,3974696.19152408
0,35,3,2,2,4,11,1888083.87616454,6700314.72696762
0,21,0,0,0,1,1,1008103.74542363,4698028.94535057
1,30,5,3,1,2,11,2375018.97574803,5129445.86476699
0,13,4,3,1,1,9,1939212.80398357,7252503.9889379
1,14,5,3,1,0,9,1728341.7523261,7962672.84216024
0,36,4,3,1,4,12,1772588.90542239,7027587.77105204
0,35,2,2,1,7,12,2263106.88544466,6177920.97908771
1,26,5,0,1,3,9,2757386.66832348,5642423.05919956
0,29,0,1,0,2,3,1789195.09871779,3839162.10201896
0,30,5,2,0,7,14,1815873.68278916,5932911.03290216
0,36,5,0,0,4,9,2249490.8275479,6643171.46019261
0,36,3,1,2,2,8,1732878.97291391,8948951.54444472
0,38,6,0,2,3,11,1759849.55212288,11078029.95489
1,29,0,1,0,5,6,1591725.227282,6402820.21682746
0,19,2,2,1,4,9,1622472.58989311,2219173.25544131
1,26,5,3,0,2,10,2020546.71797277,9396415.66123557
0,28,1,0,2,6,9,1794097.96448822,4166023.55816226
0,21,3,1,2,7,13,2275104.19241997,5696307.53959784
0,40,1,1,1,7,10,1908898.0289454,10762391.7736705
0,36,4,2,2,1,9,2198797.79695731,4679700.69960066
0,33,2,3,2,1,8,1890627.77266221,6473046.8356579
1,21,6,2,2,1,11,2335176.41269008,4256733.26668317
0,34,5,3,1,3,12,1962085.59581977,10534721.5675715
1,17,1,0,0,3,4,1404443.98076583,3946740.12106308
1,39,2,2,2,6,12,2056469.61007145,6758051.91173017
0,27,3,2,0,6,11,2817280.88147803,7295529.93444488
0,32,3,3,2,1,9,1976396.69036109,7772202.72083977
0,31,3,1,0,2,6,1896891.4895252,3421218.74039005
1,13,5,0,0,7,12,2565872.76934815,8434025.52662461
0,13,2,3,2,6,13,2200643.86228649,8660557.1809106
0,20,6,2,0,5,13,2009393.83464406,5644051.39643604
0,15,0,2,1,0,3,1172507.65663001,1912502.46081738
1,26,5,3,1,3,12,1944003.79498839,4805329.86175385
0,33,5,1,1,1,8,2051880.18523939,6459058.92991719
0,31,3,3,2,1,9,1839760.37829174,5132806.91559934
0,37,2,2,2,2,8,2072273.8594923,5884082.13769541
1,24,0,3,0,5,8,2208318.36078943,4430795.49795817
0,28,0,0,0,7,7,1628055.54996819,4655662.92960564
0,31,2,3,0,5,10,1572585.12677325,4864070.65613999
0,35,4,1,2,7,14,2841264.17754738,5562830.87487841
0,19,5,3,0,4,12,1753942.3561128,7362981.91767647
1,30,0,2,0,0,2,1217849.25061499,2613985.32733367
0,37,0,2,0,5,7,1755742.59721548,3864371.5953138
0,36,0,2,1,5,8,1570206.45051558,8726492.23142448
0,40,4,3,0,2,9,1652772.75311695,6451955.93138338
0,23,6,0,1,5,12,2168080.35781374,6292652.99849217
0,15,0,2,0,4,6,1453832.20109738,5006497.46861633
0,29,3,3,1,6,13,2514349.69786206,8299860.16102601
0,27,1,3,2,0,6,1264878.26640876,6346675.03699188
0,14,4,3,1,6,14,2473661.42179887,5300778.51055289
0,34,5,0,1,1,7,1937100.12979301,4670121.88060569
1,33,6,1,1,3,11,2204158.49610605,5585858.60929654
0,17,1,0,0,0,1,1112615.50805651,5373327.87761316
0,34,6,2,1,7,16,2694654.10245063,3851705.32831281
1,37,4,0,0,5,9,1446909.76946148,5144718.16951774
0,11,6,1,2,0,9,1787810.58249315,5530276.96281043
0,25,2,2,0,1,5,1574469.76389492,4806484.87254064
0,22,4,2,0,6,12,2482412.99165967,7576241.22132171
1,12,4,3,1,0,8,1296465.80915177,4744852.61100319
0,29,4,1,1,4,10,2450518.33516736,6863674.5037161
0,24,3,0,2,6,11,2511593.4376177,7155854.52255082
0,20,2,0,2,0,4,1043289.13551967,5234858.80264985
0,25,5,0,1,4,10,2026973.59368251,5202457.9304567
0,31,3,1,2,3,9,2054012.13200703,6306617.09110448
0,17,3,2,1,1,7,1850890.36853407,6098453.63161285
0,11,0,1,1,5,7,1795084.83586594,3274068.52716486
1,25,3,1,1,7,12,2829452.35102623,6307486.3760292
0,25,3,0,2,5,10,1968437.11931393,6541164.75376999
0,28,1,3,1,5,10,1733146.19049276,10039623.9092061
1,34,2,3,0,4,9,1835653.90194743,4853782.81695169
0,30,3,0,1,0,4,1253611.22426935,4645070.67903844
1,18,6,1,0,3,10,1919292.5560111,5385308.54628317
0,16,1,3,2,1,7,1684369.15107146,4214634.99342664
0,10,3,1,2,1,7,1367162.32200457,2048573.85352415
0,18,6,1,1,2,10,1666124.05576338,8345465.30652802
0,26,6,2,2,1,11,1854749.84718333,6328184.87549101
1,15,4,2,1,5,12,2213531.48209628,6038703.36561288
0,36,4,1,1,7,13,2095907.3777899,7330132.3876065
1,34,1,0,1,7,9,2491902.79624716,3999222.16025133
0,30,4,3,0,1,8,1739993.76955003,5037331.95769932
0,32,1,0,2,5,8,1659041.80552692,6840559.63309847
0,28,3,3,2,3,11,1835977.21256007,7988983.47898718
1,18,5,3,0,2,10,2694868.12917109,6446732.73368074
0,36,6,0,0,5,11,1673382.28159878,3442370.08583849
0,20,0,3,0,6,9,2589200.505563,5694856.28387998
1,19,0,1,0,6,7,1472791.15888872,7038536.69579529
1,29,3,0,1,2,6,1749315.70044663,1007317.56894449
0,11,2,0,2,1,5,1311683.33849114,373969.356588074
0,32,0,3,1,5,9,2385063.07853527,4854481.67157104
1,23,5,1,1,4,11,2241739.09659413,8328219.08643655
0,25,0,3,1,3,7,1581636.78042774,3178950.29679436
0,20,3,2,0,4,9,2167849.79217633,8440568.23687566
0,25,3,0,0,5,8,1534313.50999859,5022299.82335592
1,38,3,3,1,6,13,2865449.15926989,7730477.11229838
0,16,0,3,2,6,11,2191961.45887785,4135794.92390852
0,40,1,0,2,1,4,1424394.26235643,4162649.12243097
1,26,1,0,2,2,5,1398450.32717146,4910761.87455792
0,39,0,3,1,1,5,1244821.40448204,4975805.79089148
0,23,0,2,2,2,6,1880588.68181919,5465826.15605752
0,14,0,3,1,0,4,1218229.45060211,1893965.99485313
0,23,5,2,1,4,12,1698665.72140558,5061237.94370263
1,27,5,0,1,2,8,2030456.71685282,6618205.03029648
1,12,0,3,0,2,5,1403367.2563394,366733.713019934
0,14,0,1,2,4,7,1779095.13399344,7666886.70749442
1,35,6,3,1,5,15,2900405.65050946,4194539.22532913
0,36,4,0,0,7,11,1911166.71996593,8719009.44681089
0,31,5,3,2,1,11,2167025.32331186,5400153.06237879
0,21,1,1,2,7,11,2288998.91616395,5683173.43778745
1,27,3,0,2,0,5,1485514.06467379,5007049.87400098
1,36,6,3,0,7,16,2123003.77266734,7600072.8306255
1,34,0,2,2,0,4,1348756.15964857,3262903.76783031
0,11,5,3,0,0,8,2184299.52283908,3415205.31523213
0,37,3,3,0,2,8,1671723.00514286,4162476.16047207
0,26,6,3,0,3,12,2001423.54763567,7458042.21480057
1,26,0,1,2,5,8,2010092.14173125,4952623.96852507
1,22,0,2,1,1,4,1470075.5361428,2968615.55577348
0,13,5,2,2,2,11,2178108.77350961,7618018.78189477
0,12,5,1,0,6,12,1959508.67176586,5616852.40422477
0,24,2,3,1,4,10,2294285.83739681,2720243.96106799
0,27,4,1,0,7,12,2035960.57094428,7605134.63056338
0,26,1,1,2,1,5,1566320.79725345,5691251.40428848
1,18,2,0,2,6,10,1831843.65742757,5616189.4502895
1,36,6,1,0,4,11,1993384.2670997,5565246.33432326
0,21,0,3,1,3,7,1384256.10708388,5873180.65768748
0,30,2,0,0,5,7,2040959.73397089,2740701.45066761
0,35,1,2,0,4,7,1598159.36699209,5232305.39296147
0,36,5,3,2,3,13,2592515.80408433,9773987.5555985
0,22,6,3,0,6,15,2973982.71848468,4978537.91420363
0,25,5,0,0,7,12,2821043.11838911,8343873.37022527
0,31,3,0,1,5,9,1592627.79174726,6558059.176312
0,20,1,1,2,6,10,1756463.30104053,6864306.63074637
0,40,1,0,0,2,3,1208448.35311248,4623019.90770975
0,31,3,3,1,5,12,1600995.13880152,6566920.71404121
1,40,3,3,0,2,8,1671111.14527094,6806881.58378074
0,32,0,2,0,1,3,1668526.7746529,2931541.1485309
1,27,1,2,0,3,6,1735340.14587303,3245974.76871454
1,37,6,1,2,6,15,1857132.09122358,8344536.93212978
1,35,4,0,1,1,6,1641535.03560098,5361012.46832515
0,40,6,2,2,3,13,2561694.90103273,8810387.48068683
1,16,0,0,1,2,3,1165030.01271353,4875039.45293516
0,14,1,0,2,3,6,1216457.46898363,7582001.96719183
0,39,2,3,0,2,7,1582090.41988724,5941328.00978122
0,11,3,3,1,2,9,1940852.12382865,3567175.08560785
0,36,2,0,0,3,5,1487041.13854152,4203634.79295655
1,23,2,0,1,6,9,2065723.97327351,3872719.37418599
0,15,0,3,0,5,8,1807942.77087719,5792254.84071979
0,18,5,1,2,4,12,2184338.93130026,7004592.45529564
0,29,0,1,0,4,5,854710.811790292,5272966.85096193
1,26,2,2,2,4,10,1547599.34311612,7555798.73560126
1,13,0,2,0,4,6,1500920.97159686,5767271.192897
0,29,4,3,2,5,14,2075807.77792588,9507671.37003156
1,36,6,2,2,7,17,2862458.91620849,8471378.41856802
0,19,0,1,0,6,7,1749414.62719973,3154902.00731442
0,17,3,1,2,7,13,2500245.86875737,493853.596436334
0,35,3,0,1,7,11,2176806.07108834,9443904.69418113
0,18,4,0,2,6,12,1749456.9155723,9424295.02003123
0,19,2,3,1,6,12,2240902.21240204,8436178.30759737
1,38,2,0,0,6,8,2130693.37104679,5792940.89340658
1,29,4,0,2,4,10,2610146.0458732,6605884.48925151
0,11,1,3,2,7,13,1804628.88307705,8484196.12559241
0,22,1,1,1,6,9,2097811.71116708,4991026.87357266
1,35,5,0,2,4,11,1891093.67799073,9189059.68911482
0,16,2,2,1,1,6,1946503.10347237,2643925.78765214
0,33,5,2,1,2,10,2048820.15699385,7111536.86979546
1,40,2,2,2,0,6,1860634.02785159,3047500.28335983
0,16,0,1,2,4,7,1839684.4939558,3327464.5629456
1,38,5,0,1,1,7,1927204.56180723,7590739.26117539
0,23,3,2,0,6,11,2508632.76296715,6680140.79281137
0,11,6,0,0,2,8,1723335.06975592,5070925.00055101
1,11,2,0,2,3,7,1637626.32404708,5942176.5216304
0,30,4,2,1,1,8,2122082.38598788,3118707.75095561
0,29,1,1,0,2,4,1088474.15678621,4213410.86808233
0,33,0,3,0,4,7,1712366.61093767,5688078.42214527
0,40,0,1,2,6,9,1995027.57694193,8334057.30089836
1,10,0,1,1,7,9,1880696.52055721,5107461.76336714
0,23,2,1,2,5,10,2139913.27354509,4569271.84446507
0,19,5,0,2,6,13,2208638.41918608,7142957.46620968
0,21,5,0,1,6,12,2182459.19715344,3399217.37741755
0,21,3,2,2,0,7,1088376.0825577,5722195.09929286
0,36,4,1,2,6,13,2494972.18636264,6755911.51274059
0,25,6,0,0,6,12,2473282.3368582,5532746.94878685
1,15,4,3,1,2,10,1763043.90618756,2076128.29711088
0,19,4,1,0,0,5,916323.160072181,5137752.1356327
0,20,1,2,2,6,11,2420324.43551607,4770681.21674128
0,16,6,1,1,6,14,2409594.07346634,5949287.22347132
1,34,3,1,1,1,6,1827337.67789985,3425805.50360426
0,20,0,1,1,2,4,1189417.75576576,5671296.76674964
1,21,4,0,2,0,6,1688972.95068263,5354509.44291066
1,10,4,3,1,1,9,1999526.2851037,6603130.48623706
0,25,6,2,1,0,9,1236798.65998764,5714829.19292196
0,29,1,2,2,4,9,1984837.18215079,2946172.23367972
0,18,5,3,0,1,9,1501402.26778139,5925773.48051629
1,13,5,1,2,3,11,1844905.11867603,7815003.80579561
1,16,6,2,1,3,12,2419972.68925336,5846200.96469224
0,39,1,3,0,2,6,2100475.16411531,2608666.63147844
0,17,6,2,1,6,15,2012599.87885246,11165659.8363666
0,24,0,0,2,5,7,1900808.59116979,6166264.15107751
1,28,6,1,2,6,15,1895639.055741,7463158.9923806
0,14,5,3,1,2,11,2069725.55261699,3830143.61666737
1,13,3,2,0,5,10,2149032.29827287,3780139.07644032
0,39,1,3,0,6,10,2272259.1492127,4541572.82721517
0,34,5,3,2,7,17,1945094.54902729,6063415.77823119
0,33,0,1,0,5,6,1629273.7531456,5974019.82951954
1,31,1,3,1,4,9,2137842.55206406,2867817.40892165
0,10,4,2,0,1,7,1774795.31786662,4149193.38637044
1,11,1,2,1,1,5,1385412.79480679,5160354.65753843
0,25,6,3,1,4,14,2110244.80436841,10482878.9430673
0,17,1,1,2,7,11,2214888.49030119,5421018.39663278
1,18,0,0,0,7,7,1392632.28565639,4941782.31187614
0,39,1,0,0,7,8,1500956.64703169,4087789.55392687
0,13,1,1,1,6,9,2021035.61044466,5052047.74685356
1,20,0,0,2,4,6,1601665.28739569,5139563.36606505
1,35,2,3,1,2,8,1344546.26749843,4203597.93463596
1,29,5,3,1,6,15,2201709.5756425,9005143.21064494
0,29,0,2,0,6,8,1423848.30040061,6648107.94015223
0,32,0,2,0,0,2,1384617.80743438,4494483.89157167
1,32,5,3,1,4,13,1686415.27175814,6498531.59296861
1,39,5,1,2,2,10,2708901.61438945,5090039.88478483
0,34,3,1,0,6,10,2242389.39493531,9107298.11374174
0,29,3,3,0,7,13,2178614.77561407,6119807.38943441
1,34,2,1,1,6,10,2113873.85962156,8593503.95421829
1,26,1,2,0,7,10,1310607.84400488,6490003.84923388
0,16,6,1,1,0,8,1901388.7189588,8365554.58954998
0,35,2,2,0,4,8,1731786.87569762,11859540.5428625
1,19,6,1,2,6,15,2204598.44688587,8250695.74880331
1,28,0,3,2,7,12,2460911.977305,6612051.80778267
1,20,2,3,0,0,5,1746590.6985751,4914365.58316666
0,10,5,2,1,0,8,1947479.06549196,8528569.94983108
0,29,5,1,2,7,15,2319248.75924089,8335414.53260101
0,13,3,0,1,2,6,1210919.88787572,3415428.8525841
0,11,4,2,0,4,10,1735990.75499944,5294213.21336677
0,12,1,3,1,1,6,1471557.6223218,4615764.66783288
0,17,2,2,0,6,10,1959962.96239009,4962648.62793316
1,13,3,0,2,6,11,1656103.79520947,4490294.32969356
0,21,0,3,2,4,9,2309163.14629793,6889417.35678332
1,30,5,1,1,0,7,1485284.47396324,4748572.88260976
0,12,3,1,1,6,11,1819625.58048734,5677515.74670435
1,39,0,2,1,2,5,1806259.19868657,3078653.44146701
1,40,2,2,2,5,11,2161011.37871278,4726817.88103141
1,27,4,0,0,6,10,2520826.00061549,4807220.40754957
0,37,6,0,1,1,8,1399585.58109491,3353780.55555396
1,27,2,2,0,6,10,2549196.53846284,6420055.01341745
0,30,5,2,0,0,7,1729814.80645849,1937698.51888635
1,37,4,1,0,3,8,2129142.00981772,4057011.74199622
0,24,1,2,0,7,10,1819388.07468563,8431579.37624042
0,26,6,0,0,2,8,1438720.25400838,2099058.4769178
1,20,0,3,1,4,8,2040831.67439472,5495881.42860137
0,36,2,2,1,2,7,1267274.36467433,3942113.19064623
0,31,4,1,1,7,13,2152201.93426425,5351868.28487123
0,32,1,3,1,2,7,1665013.28867953,4984872.14329232
0,24,2,3,2,2,9,2215912.69610374,7623767.84491325
0,16,3,1,1,0,5,1578229.71542031,1112560.5751968
0,33,1,2,1,3,7,1587686.61893836,5998167.49729185
0,17,1,1,2,4,8,1396734.26857268,6059825.36236991
1,25,6,1,2,7,16,2234803.30236453,8154458.07281424
0,10,2,3,0,7,12,2344759.45535527,5716826.4466972
0,31,0,3,0,4,7,2153300.2037814,4954021.84320485
0,15,6,0,0,5,11,2172822.58476125,5367267.28853021
1,32,6,3,2,0,11,2159502.27332098,8469637.36097339
1,38,3,0,1,3,7,1863354.2190542,5953733.34578137
1,27,6,2,1,4,13,2454468.67830812,3413152.44560805
0,13,2,1,1,2,6,1929174.48224051,6253398.89593292
1,38,2,3,0,2,7,1749039.62028501,5850813.94209338
1,26,5,0,2,4,11,2240736.08685794,5662238.02472486
0,28,6,2,1,1,10,1962408.45640847,7318849.75966595
0,12,1,2,2,4,9,1806363.88848194,9627872.19933585
0,38,2,0,1,3,6,1809057.14255721,2401450.04146943
1,13,3,0,1,4,8,2282564.90264014,3671780.58277939
0,38,2,0,1,6,9,2006408.16086333,2825612.64554116
0,18,5,2,2,5,14,2318535.22731546,7953656.35536368
0,35,5,2,1,2,10,1958201.21165256,3579377.81274627
0,34,4,0,0,1,5,1405754.57845674,7742651.9334512
0,27,5,2,2,4,13,2284237.82167109,6393191.85681439
1,25,6,3,1,7,17,3164556.02006408,8295155.8556808
1,10,3,0,2,0,5,1508124.58771557,5646948.16985031
0,36,3,1,1,6,11,2091822.7738691,7950798.28584798
0,16,1,2,2,4,9,1800920.15078493,5325285.29688045
0,28,0,2,0,7,9,1931061.20881013,3741283.90640752
1,16,1,0,1,1,3,870777.355153223,5102867.35673044
1,18,0,3,0,1,4,1272462.04788371,2740156.72955801
1,21,0,0,1,4,5,1818436.89691372,5556721.77756879
1,18,4,1,0,5,10,2324372.68140912,1519006.04524731
0,18,6,3,0,7,16,2828686.09643051,10079154.7715252
0,21,2,2,1,6,11,2523980.06962874,6374279.56165743
0,14,6,0,2,2,10,2374343.78498644,6301487.24726509
0,37,5,3,2,2,12,2649531.92357808,8689551.58979918
0,28,0,1,0,3,4,1205731.75780013,4649704.32566409
1,39,4,0,1,2,7,1620180.93594938,3491691.68327281
1,23,5,2,0,2,9,2439141.14149863,5432562.01520164
0,37,2,0,0,1,3,1196446.79745758,3504341.96688247
0,32,5,2,2,5,14,2179485.16820939,7652861.11375129
0,25,4,2,0,2,8,1571322.71573592,5712922.533804
0,26,1,0,0,0,1,1484027.82399942,4591623.26469922
0,26,5,1,0,0,6,1831248.60832721,3278258.97269523
0,15,3,2,1,5,11,2509092.54919839,7816567.43453454
0,29,4,1,0,5,10,1726420.35478168,6627516.1552573
1,16,3,1,0,1,5,1532824.21466578,6241510.93876666
0,19,5,0,2,4,11,2184783.99188743,7277767.65305695
0,39,4,2,1,2,9,1984914.56857246,7198385.90788122
0,36,4,1,2,7,14,2966720.67693307,6935243.53708783
0,39,2,0,0,6,8,1628397.7266272,3150870.35206426
0,31,3,2,1,2,8,1983581.1525647,9137761.7871744
0,20,0,2,1,4,7,1414093.66517785,1998996.47453091
0,35,3,2,1,3,9,1844244.22982076,4913711.61944901
0,15,4,0,2,3,9,2088650.69278478,7278066.12387844
0,13,3,2,1,3,9,2757284.2112122,6236361.39071424
0,36,4,0,1,2,7,1644533.41287662,5833443.16050607
0,34,4,0,0,0,4,1309781.31294393,4608808.04941407
0,40,2,1,0,4,7,1527285.84293665,3598359.80082639
1,14,6,1,2,2,11,2417216.13850357,7611133.0663033
0,12,6,2,1,1,10,2026532.36014105,5952818.96368622
0,31,0,3,2,3,8,2331866.83668813,3992976.01252366
1,13,0,3,2,5,10,2489213.29180368,3937795.77373382
0,30,1,2,1,4,8,2066541.50947512,5082043.14568221
0,28,0,3,0,6,9,2152916.03062667,996804.455368888
1,30,3,3,0,7,13,2618492.76767201,4417016.95562087
1,32,5,3,2,2,12,2692755.93431596,4154234.41304438
0,13,6,3,0,5,14,2608767.29404879,9638094.11145816
0,39,0,3,0,1,4,1396633.02078675,4759387.10532468
0,29,3,0,2,2,7,1842504.26063543,5890311.50700815
0,10,5,3,1,7,16,2082200.47244921,7508348.59043956
1,33,2,3,1,2,8,1899318.49725819,4820001.35417822
0,16,5,0,1,4,10,1310767.64816527,4901394.84593954
0,37,1,2,1,7,11,2247314.67784316,6545246.8855678
0,10,6,1,1,5,13,2608589.69023066,8664722.21607094
1,36,2,0,1,4,7,1540409.58879905,2113811.48355645
0,12,6,2,1,5,14,1998609.04703866,7607042.69976325
0,38,0,3,2,1,6,1806989.17473897,6042846.73489988
0,17,6,1,0,4,11,2571588.22101711,4969533.88449112
0,28,2,2,2,3,9,2103275.14701327,5484791.21565204
1,21,6,1,0,2,9,2010816.51921597,10334601.2736464
1,40,6,1,1,7,15,2211813.49670306,5805435.85766299
0,31,0,0,2,7,9,1981890.53969655,3456883.08116843
0,24,3,0,2,1,6,1583422.44044078,5761634.73526073
1,15,3,1,2,1,7,1874331.00971288,2979034.37385269
1,20,4,1,2,7,14,2776096.40494131,7538016.95179466
1,22,3,3,0,4,10,2387994.94925558,7810347.61687233
0,14,3,3,2,5,13,2213193.67645553,1956926.02544167
0,23,6,3,0,6,15,2449429.47518838,9714146.30248093
0,38,2,2,2,3,9,1861724.9455856,8783886.58919281
0,33,5,1,1,2,9,1972544.09048192,5293402.8886054
1,31,1,3,2,3,9,1608602.66460026,5740162.46195942
0,29,2,0,2,6,10,2496689.56228603,7244090.25580117
1,22,3,1,2,5,11,2643668.08953845,7798201.62335169
0,32,2,3,2,3,10,1488913.24967883,2506880.78222591
0,31,4,0,2,2,8,2097069.40572984,4754814.00307726
1,14,2,2,1,5,10,2180100.50204981,5058764.06918334
1,22,4,3,1,3,11,2165463.64128881,6640467.65048596
1,38,3,2,0,7,12,1595177.89434151,8700427.19790475
0,39,1,3,1,7,12,1441152.305084,2669837.95985248
0,27,4,0,0,7,11,1399472.39801355,5079905.54697562
1,29,0,0,1,3,4,1272802.45413297,2644577.13469869
0,14,3,2,1,3,9,1687887.3461787,7632710.41435101
1,25,4,2,1,0,7,1595177.44515407,3123005.87529737
0,13,1,0,0,2,3,1463778.09584246,4968346.60553995
1,34,6,2,0,5,13,2348089.16178632,9257765.2518966
0,26,1,2,1,6,10,2016227.78145138,5826697.91345167
1,10,4,2,1,1,8,1526881.72921309,5776592.21348915
1,38,1,2,1,3,7,2188456.03094338,5213555.47403646
0,38,4,2,2,2,10,2071050.49554694,8409696.40667429
0,40,4,0,2,0,6,1661985.25130603,4709252.39076315
0,30,2,0,0,4,6,1619006.47606413,2562233.19479325
0,14,1,2,0,1,4,1216074.25914499,2798091.53585434
0,15,6,1,1,6,14,2909962.02296751,7454026.05648068
0,29,2,1,1,4,8,2231732.76728719,7484566.13883973
0,30,5,2,1,5,13,2509989.11606394,4996150.26353063
0,34,1,0,1,5,7,1495262.84592436,4561202.66289089
1,31,5,3,0,0,8,2330451.39124661,1339123.36978666
0,33,0,3,0,1,4,1553862.58558639,4403078.96617807
0,14,1,0,1,0,2,1265633.41594711,5008166.13370472
1,34,2,0,2,1,5,1075125.02088418,2889971.9259967
1,39,4,1,1,4,10,1913523.48533793,4876864.21368244
0,34,0,1,0,5,6,2312745.49130559,4924292.73981439
0,29,4,2,0,5,11,1638965.77847147,6214310.25621423
0,34,6,0,2,4,12,1915117.49267715,7771067.07045703
0,35,5,3,2,7,17,3647704.4588815,3176604.94058776
1,29,5,0,0,1,6,1619879.96295356,3932047.67600407
0,19,6,0,0,1,7,1439853.7702824,4334910.6096555
0,35,4,0,0,6,10,1452949.2920703,8343171.29029264
1,24,5,0,0,4,9,1156694.4349368,5783016.08542881
1,13,5,0,0,3,8,1734793.12610692,5291519.70628406
0,33,5,3,2,2,12,2505193.78343788,7565345.62430039
0,26,2,0,0,2,4,1671414.10340358,5691986.10618591
0,38,0,1,0,0,1,1024271.51311313,4298397.99463195
0,32,0,1,0,4,5,1461076.58036115,3007495.6255233
0,34,5,3,1,2,11,2535133.48724466,8132098.85783866
1,36,1,2,1,6,10,2459195.38863163,3538406.33224776
0,22,4,2,0,0,6,1742257.18834356,3281346.74655186
0,35,6,2,0,2,10,1757465.41547581,6428952.81828545
0,37,6,1,1,0,8,961671.780558744,3473613.68673165
1,38,3,3,2,4,12,2336635.77969393,9235761.27861098
0,21,4,0,2,3,9,1728211.13546188,6257211.97590137
1,35,1,2,2,2,7,1826011.94727028,5323794.6070654
0,18,3,3,0,7,13,2473474.24801072,8413530.13880632
0,18,1,1,0,7,9,1625814.92200174,5291118.73776551
1,37,5,1,1,0,7,1884296.78565838,7334789.50565175
0,36,0,3,2,7,12,2114842.65962142,7560955.57670433
0,40,3,0,0,4,7,1589170.09643334,8067302.51774147
0,39,6,1,1,2,10,2722270.74967824,5521955.73055241
1,23,3,1,1,6,11,2029651.61492288,6952739.61533009
0,39,1,1,0,5,7,1835884.67380207,5696475.12968866
1,32,2,0,2,4,8,1925833.53658971,4498102.1070937
0,25,4,0,2,2,8,1993292.69595027,4782116.92823505
0,38,3,0,0,3,6,1687906.89084886,6123656.54304776
1,24,5,3,0,1,9,2181179.82810204,7458469.89046396
0,14,3,2,2,6,13,2215450.8975549,10745622.9635319
1,20,6,2,0,3,11,2458089.99685393,5071535.43341862
0,15,1,3,0,0,4,1906986.46166554,3695282.73618548
0,15,5,1,2,5,13,3042827.23064533,7693241.96600809
0,23,5,0,1,4,10,1856454.15738486,9692944.35705741
1,36,0,3,2,0,5,1610220.52240144,5630656.11139883
0,26,6,3,1,5,15,2179608.17261934,8578059.79836705
0,27,1,0,0,1,2,713782.086302064,4429886.44583915
0,37,2,1,1,1,5,1393474.41134821,5368225.49451514
1,27,1,2,2,2,7,1770962.94860274,6399061.95356197
1,31,5,1,2,7,15,2926005.45103509,7473462.40638878
0,35,4,1,1,5,11,2442235.36893833,7167476.73591828
0,14,1,2,2,5,10,1856118.21534121,7824649.02552597
1,26,2,1,2,6,11,2357132.72006825,7832055.98498554
0,32,0,0,1,0,1,1126383.02971128,2644501.50730883
0,11,2,2,1,1,6,1625107.90151794,3772729.99354214
0,14,4,0,1,1,6,1635737.64341778,2137776.42393454
0,37,5,2,2,0,9,1907010.77179871,2461236.97547524
1,22,5,3,0,7,15,2154967.0873129,7446583.33070344
0,18,5,2,2,3,12,1847566.72686739,6106575.60580505
1,24,6,2,1,0,9,2024239.97129406,9002873.16187529
0,27,2,0,1,6,9,1696510.78974064,2651747.113764
0,11,0,2,0,2,4,1200513.17535789,1766476.34624558
0,18,1,0,1,2,4,994721.100926925,6522003.21019209
0,14,3,2,2,5,12,1712604.4155664,6075771.76241121
1,23,1,1,2,3,7,1923417.97482035,5071916.73500192
1,19,3,3,0,4,10,2383396.07443425,6887776.71326077
1,40,4,3,1,7,15,3231716.19048224,6576962.00771938
1,30,2,3,1,7,13,2291269.76361253,6804650.48609419
0,14,4,3,0,4,11,1693962.05058856,6895143.19443432
0,20,3,2,2,3,10,2012281.52337891,6275765.41067792
1,36,5,0,2,3,10,2439709.41956033,5881293.65542296
0,32,4,3,2,2,11,1927827.44346839,7331609.00447945
0,29,3,0,1,6,10,1524481.89645653,4848936.51205514
1,11,4,3,1,6,14,3211432.33317531,11566899.465389
0,15,2,0,1,5,8,1944007.43680986,6691681.81093629
1,27,2,1,0,7,10,1808414.70859414,1621116.78350234
0,22,4,0,0,4,8,1722161.85464227,5603237.26858228
1,13,0,0,2,2,4,1345806.66978719,4820102.09206997
0,13,2,2,1,7,12,2098711.0391549,6293591.7611529
0,24,6,0,0,3,9,1802282.4573137,6729661.00843008
0,24,1,1,2,3,7,2068232.65987704,5631392.79096952
0,33,3,3,1,5,12,2058441.43248997,9292325.63740687
0,28,1,1,0,4,6,1677647.31132313,4816783.1648905
0,35,1,3,1,5,10,2194966.45848014,2719167.18375927
0,12,6,0,1,7,14,2401977.10620632,7884154.37188338
1,28,1,2,0,6,9,1568250.48005323,5623295.01611178
0,29,6,0,0,2,8,1833612.74446777,3942610.87310889
0,23,4,0,1,4,9,1644557.85522338,7848674.577168
1,35,4,0,0,0,4,942727.084366189,5171420.13505113
1,16,2,3,2,5,12,2717337.54329757,7365459.18682931
1,33,4,1,2,5,12,2953303.17350308,6992260.8392856
0,19,2,3,2,1,8,1756136.41153509,1215053.29367467
0,14,5,0,0,5,10,1628537.39605953,5280764.25580195
1,40,5,1,2,7,15,2433295.08994233,10305643.6024639
0,36,0,1,0,6,7,2002808.35753555,4212951.51472424
1,14,0,3,1,7,11,2466574.90359085,7094977.21797537
0,37,5,1,0,7,13,2280115.92547997,9617440.89337387
0,33,0,2,0,4,6,1733864.94952104,4227087.0721123
0,38,1,1,2,3,7,1526021.85565367,2980847.00132583
1,22,2,3,1,2,8,1203500.64482249,4929642.71963253
1,24,5,2,0,5,12,2053464.18396665,7164245.83096664
1,18,0,3,0,6,9,2006329.3941106,7482737.30414772
1,38,4,1,1,6,12,2482169.98829624,8412009.79746588
0,33,3,2,2,6,13,1647588.96678061,3347276.06705795
1,14,2,0,2,4,8,1498382.66750731,7001682.02508668
1,26,3,2,1,1,7,2391890.43743742,6715631.76748276
1,26,3,1,0,3,7,2078170.60363663,5663902.0295162
0,27,0,1,1,5,7,1572991.35042422,4093131.0819857
0,22,2,1,0,4,7,1575912.28936367,2389070.57401341
0,19,1,2,0,4,7,1527990.0025314,7336296.28606931
1,27,0,2,2,5,9,2132286.36628713,5499849.92136319
0,14,4,2,2,6,14,2659550.56838388,6023728.43849859
0,17,2,0,2,4,8,2041305.27537924,4563251.87419887
0,32,5,3,0,6,14,2155163.98212722,8704883.92334065
0,11,4,3,2,0,9,1927621.72180942,2645296.01948705
0,31,1,1,1,2,5,1498426.28976157,1822412.59044234
0,28,3,1,2,5,11,2289887.84830555,6830300.24204714
1,12,0,2,1,6,9,1583725.37487697,8572195.15515409
0,38,3,3,2,5,13,3002122.11738003,9426716.71049694
0,19,6,1,0,1,8,1812607.14306582,4220248.91557568
0,37,1,2,2,7,12,2644719.34561225,10701285.8323337
1,40,4,3,2,5,14,1855849.18839394,2989874.27636852
0,39,5,3,0,2,10,2051221.8242891,7700372.62830505
0,32,5,2,0,7,14,2743064.18793736,6171300.02547013
0,21,1,1,1,6,9,1640707.29089163,8229453.95783461
0,18,3,0,2,0,5,1712875.96369433,2202974.94131052
0,21,1,2,1,3,7,1637556.11841584,5037239.32722476
0,38,6,3,2,3,14,1873920.12539591,5404631.68111083
0,10,3,3,2,0,8,1791360.46848355,2651769.7042209
1,13,0,2,1,0,3,983201.818701617,4757208.95145737
0,37,0,0,1,6,7,1695580.256402,4060431.85500478
1,12,0,3,2,3,8,1516758.30033659,4908065.09097264
0,26,6,3,1,1,11,2450850.7221278,3589935.74866873
0,10,2,2,0,0,4,1609628.30506818,3895961.62654398
0,27,5,1,2,4,12,2711102.31394166,6479412.0190849
1,10,6,2,1,2,11,1784704.5223033,4802320.41965338
0,23,4,2,2,1,9,2280368.13824916,6334696.89914205
0,18,4,2,0,4,10,1540032.46121806,6117234.00626139
0,22,4,1,2,2,9,1556814.97935955,4683912.19911853
0,19,3,3,2,2,10,1421344.54866317,6596327.20014447
0,38,1,0,2,0,3,1400926.28927278,5023294.06927812
0,29,5,0,1,6,12,2345870.77508321,6473343.37679952
0,39,1,1,0,3,5,1922457.54918968,3911819.11351895
0,13,2,1,1,4,8,2433917.89767302,4084963.82842614
0,25,5,3,1,7,16,1970049.68500183,9024859.86518626
1,29,1,1,1,4,7,1672028.87912308,3840288.97782393
0,27,2,1,0,1,4,1284484.76704341,4949126.72522525
1,22,0,0,1,2,3,1761733.07358361,5745858.70223772
0,17,5,1,2,2,10,2115023.78388588,4470863.47874753
1,27,3,3,0,6,12,1787883.89182153,7848689.30131152
1,38,1,2,0,4,7,1669571.42422006,2695015.11537105
0,32,3,0,1,4,8,2232711.34523135,3298367.1662042
0,27,0,0,0,5,5,1544459.61779647,4471487.8998641
1,15,5,0,2,7,14,2869613.86869605,10417097.433225
0,29,4,1,2,0,7,1417187.40833152,1812152.59723547
1,15,0,2,1,3,6,1439763.00415892,3657749.93390141
1,11,0,3,1,0,4,1615197.13298428,6596400.69586236
0,18,6,3,1,0,10,2407392.97648914,5596497.6796609
0,34,4,1,1,2,8,2234765.79366771,10343614.6631628
1,21,2,0,0,6,8,2420377.1359372,3946000.78806782
1,24,0,2,0,5,7,1756457.63146111,7825613.41768801
0,40,5,2,0,0,7,1444256.15990345,3785436.2851468
1,18,0,2,1,3,6,1558945.66187125,1503555.2872456
0,24,1,0,2,5,8,1485375.39080931,4706103.74413719
1,19,2,1,2,2,7,1653584.58133947,8102329.63529307
1,13,6,0,1,4,11,2361531.72825876,6518392.87161663
0,17,0,0,0,2,2,1126867.37592326,4232129.18770032
1,33,1,1,2,6,10,1731027.35244133,6863519.47624612
0,27,2,3,0,5,10,2008407.65135237,8405469.57258632
0,18,5,2,2,2,11,2192602.89205163,5789503.53459417
1,17,4,2,2,2,10,1936062.99229182,5005615.53810553
1,13,5,2,2,7,16,2514222.13968689,6651679.01598006
1,13,2,2,2,7,13,2640125.72482475,6206948.15886652
0,39,4,2,1,0,7,2400088.97877634,3287110.23089059
1,19,5,2,1,3,11,3159591.25500986,7824042.955599
0,20,5,2,2,3,12,1950319.72092968,6055770.91417164
0,30,4,0,2,7,13,3292628.6640329,7150471.25435684
0,16,0,2,1,6,9,1743340.61056298,5746587.43357559
1,22,0,0,1,1,2,1167460.05238699,1378191.27144686
0,22,2,1,2,1,6,1807469.79526714,4639249.61759452
1,10,3,2,1,2,8,1574839.57810325,5999776.22177031
0,35,4,3,2,2,11,1812775.46160762,5375813.06603958
0,13,2,0,0,3,5,1502132.49030654,4707865.33458436
1,38,6,0,2,2,10,2016856.68768947,5922865.92193945
0,21,3,3,1,7,14,2549996.44656824,9806417.25721237
0,25,4,3,2,2,11,1909827.10832119,6601492.24617821
0,11,4,1,1,5,11,2279415.95926588,3026399.21738432
0,14,1,1,0,5,7,1523709.1536284,3379968.7326355
0,25,2,3,1,1,7,1400598.77371348,5946627.40538722
0,22,3,2,2,7,14,2931277.31577936,4376449.90799638
0,18,5,1,2,0,8,1476737.72646029,5961631.26662151
0,40,6,1,0,5,12,1842766.45402229,4969652.07048857
0,16,2,2,0,5,9,2231287.57386207,7526184.67228604
0,28,6,1,2,6,15,2525138.88670607,4764546.21101804
0,37,2,2,0,1,5,1386575.74230897,3696228.21691014
0,11,0,3,2,7,12,2120919.06288785,6999233.53803558
0,26,1,2,0,1,4,1122455.46363762,4572531.91284986
1,32,6,1,2,3,12,2397514.42159847,6645777.14527719
0,37,3,2,1,4,10,2025336.01092781,8292567.46135093
1,31,2,2,0,6,10,1801744.55187244,5161993.96452685
0,39,3,2,2,1,8,1761821.58761696,7223639.47449777
0,24,6,2,0,5,13,2811256.23063387,5126649.97709578
0,21,3,1,1,3,8,2133973.73476074,5304301.18226111
1,15,5,1,0,4,10,2100060.84555181,1960237.42547835
0,18,4,1,0,5,10,1693772.26434969,5076264.8400764
0,33,3,3,2,7,15,3231298.68342992,6217933.4303263
0,36,4,0,0,4,8,1988058.66680511,6754317.35658971
1,26,5,1,2,7,15,2612457.01663799,3726178.83699964
0,15,0,1,2,1,4,2013834.78295001,3752071.74870545
1,15,5,0,1,6,12,1904842.18298273,5249790.30904265
0,20,1,1,1,7,10,1587314.86220536,8286666.23910228
0,19,6,0,2,0,8,2034504.27582761,4976857.90662226
1,39,4,2,2,2,10,2118616.78336022,5827919.13421548
0,28,6,0,1,0,7,1629910.51485688,4752628.75356247
0,24,2,0,1,5,8,2025945.05492415,1130522.45047279
0,32,6,3,2,6,17,2834871.77011189,5373827.52774452
0,39,0,0,2,7,9,1898503.47684678,6829220.22729734
0,30,3,3,0,4,10,2067510.50217077,5918478.62045292
0,26,5,1,1,0,7,1601998.26975771,7003667.23414106
1,10,1,1,2,7,11,2139161.2610925,6375717.50367918
0,24,5,3,1,4,13,2128618.85220239,6510442.50579427
1,35,5,2,0,0,7,1627099.87736069,7957830.63552528
0,23,5,3,0,3,11,2648164.98561658,6185436.27755436
0,34,3,0,0,4,7,1467385.82618666,8004511.85241438
0,23,2,0,0,5,7,1591945.09488396,4811303.99015074
0,40,3,3,1,3,10,2326662.38087697,3439368.2916752
1,30,5,2,0,6,13,2384116.17720422,1787418.58494831
0,13,3,1,0,2,6,1770646.57902938,5726042.32784198
0,23,6,0,0,2,8,2011046.52776541,8741773.75774633
0,17,6,1,2,6,15,2379152.91236396,8353260.41197506
1,18,3,3,1,7,14,2508280.16815106,7767677.21540658
0,15,2,1,2,0,5,1833543.30404394,4520817.29445262
1,39,3,0,1,1,5,1667170.82616822,2455480.02073865
0,26,1,0,0,6,7,1241942.38778504,6425941.32965346
0,30,5,1,2,3,11,2253941.70906601,6745659.78420812
0,29,5,0,2,5,12,1748268.13100539,9167643.28586021
0,28,2,3,0,5,10,1652693.67533821,4444146.77729467
0,17,0,1,2,2,5,1594907.19669452,3507275.83643704
0,23,3,3,0,6,12,2195879.19819639,7287321.62612674
0,20,0,2,1,5,8,1949387.43360895,5306891.72674191
1,13,2,1,0,7,10,2105935.16141315,5628587.9249593
1,14,6,0,2,4,12,2207974.98609515,6988475.19000365
0,36,0,3,0,2,5,1493959.14158793,1247939.37043633
0,38,0,0,2,3,5,1541267.0792442,4363389.43545294
1,16,2,3,0,1,6,1332353.92017246,3851966.20752961
0,18,5,2,2,2,11,1716184.36109761,4363012.13020974
1,33,5,1,1,5,12,3027890.37200774,10350532.6074523
0,11,4,1,0,5,10,2159755.56063816,6838037.09977493
1,15,3,3,2,1,9,1987161.20362271,6533897.09469524
0,12,3,2,2,3,10,1992450.13266283,6053521.19020039
0,14,5,0,2,1,8,1532330.89279288,4543050.42846256
0,38,3,3,0,0,6,1751818.75619219,5201017.13970337
0,29,5,1,0,1,7,1884289.7466995,6563297.70909929
1,37,1,3,2,4,10,2066480.86967175,5749520.1694843
0,17,5,1,1,2,9,2485916.83890272,3843844.13821242
0,14,6,1,2,4,13,1727061.35383282,8309696.2252622
0,16,3,2,0,2,7,2557324.81376823,5181961.62255437
0,12,3,3,2,4,12,1889489.4440244,4417038.81405417
0,24,0,3,1,0,4,1209128.03437839,6878778.79895848
0,19,0,2,1,3,6,2000900.96874338,3972519.94362769
1,11,3,3,2,3,11,2491779.84658076,7601646.99292219
0,19,3,3,0,0,6,1712866.8388036,3183242.49066003
0,21,0,3,2,7,12,2237156.19215706,6102859.82968046
1,26,2,0,2,2,6,1451325.42216137,2496823.5414314
0,34,0,0,0,6,6,1045937.86719609,3564693.01211931
0,29,5,1,2,4,12,1777148.56387476,10824183.49261
0,35,6,0,1,5,12,2321108.6983292,4239170.90187401
1,27,0,2,0,1,3,1301780.08194942,3537047.99251849
0,35,5,2,2,2,11,2449332.96205908,8864514.73234247
1,26,1,1,2,4,8,2048358.79377233,5938895.46018819
1,33,4,2,1,4,11,2224723.58142347,4497445.71000019
0,18,5,0,1,6,12,1928733.85230708,7981218.73398777
0,14,1,3,1,1,6,1579034.58757054,4506443.64280372
0,11,4,2,1,3,10,1844370.73028436,6810995.2266064
1,34,1,2,1,0,4,1526309.76781022,5256625.01551648
0,32,1,0,0,2,3,1151361.83054201,2605719.79960049
1,13,4,2,0,6,12,1757062.14388804,6998301.83172731
1,13,2,3,2,6,13,2522192.70258685,5472542.50616408
0,34,4,3,1,0,8,1675052.32243712,6773394.08681382
0,37,0,3,2,3,8,1815675.53334604,3727593.56788568
0,35,0,2,0,7,9,2155888.59283222,3498796.55054438
0,10,0,2,0,3,5,1188487.68236434,3737600.32885173
1,20,4,3,0,0,7,1848596.48366449,3880125.0523051
1,32,6,1,0,6,13,2518034.40568884,8552642.11747169
0,23,3,1,0,7,11,2175841.08397116,9454447.15844652
0,35,0,3,1,3,7,1770537.12290163,5460169.67561439
0,23,2,2,2,4,10,2738789.90456771,6513685.54115418
1,11,1,1,0,7,9,1929576.99890583,7203370.22502817
0,32,1,1,2,3,7,1658325.24573711,3168438.15592681
0,18,1,3,1,4,9,1947219.41345542,5861755.97053594
0,10,5,0,2,2,9,1550428.47358711,6211256.36264811
0,17,4,3,2,1,10,2089102.08046767,9566920.07202216
1,13,3,0,0,0,3,1312683.01712376,5000411.00127183
0,15,6,1,1,7,15,2704754.10574765,8075458.24163543
0,32,0,0,1,1,2,1473542.48138778,4257551.27210645
0,29,5,2,0,0,7,1645146.3741415,4411567.69629377
1,12,0,1,1,1,3,1392331.374555,4410292.32754449
0,10,5,3,1,5,14,2061932.04647745,7083031.7036209
1,14,3,1,0,3,7,1873564.62412209,3474781.78610826
0,17,0,0,2,3,5,1546911.38337903,5078768.14040164
0,38,1,3,2,6,12,2398675.3632244,6795497.32168808
1,18,4,0,1,5,10,2385355.47168344,5714308.44148719
0,13,0,0,0,6,6,1676541.43987161,2749092.93934113
1,30,4,1,2,0,7,1946835.28250124,4122037.93094523
0,40,0,2,0,2,4,1541961.53427779,4286699.68232271
0,35,6,1,1,2,10,1980571.55597751,5949057.2699389
0,30,0,0,1,4,5,1303833.52029618,3767475.95251311
0,11,3,1,0,1,5,1183331.05421784,3257764.86732846
0,22,2,0,2,5,9,1746963.37491591,5662370.05461032
1,22,4,0,2,5,11,1975672.4682778,5021331.91506067
1,34,5,1,0,0,6,1524920.70727079,5799961.46116955
0,15,3,3,1,6,13,2184355.11338243,5792146.76439057
1,17,1,1,2,4,8,1836280.89566355,4124670.94296823
1,33,6,2,1,2,11,1855847.4109761,6923476.00021141
0,16,1,3,0,2,6,1586425.92107112,4823053.19677524
1,38,1,3,1,3,8,2216245.43751643,6204594.10058175
0,29,5,1,0,2,8,1798066.51798991,7276686.56830297
0,33,0,0,2,2,4,1242504.70888672,7705942.46269552
1,11,2,2,0,6,10,1345554.39648535,4473977.02448984
1,35,3,1,0,3,7,1654561.0510988,4051573.34724467
1,37,4,0,0,2,6,1685751.70004693,6290411.08022834
0,30,6,0,0,0,6,1152347.3023849,8265682.46125142
1,36,0,0,2,3,5,1497187.07306025,3950033.70304221
1,23,3,1,2,0,6,1242551.65691073,6798936.07648379
1,36,3,0,0,0,3,1453977.24368458,5387148.60370788
1,24,4,3,0,2,9,2172831.23257892,6087769.14010423
0,36,4,1,2,5,12,2035677.43410823,7229522.99053412
0,14,6,2,0,5,13,2462878.81900246,7388354.76673896
1,23,3,3,2,4,12,2008797.63397223,7235730.82715208
0,25,3,3,1,6,13,2102894.48539259,7016324.78325308
0,14,2,0,1,0,3,1418641.10384949,5311874.54650152
0,35,0,0,0,0,0,1040813.81176999,3218394.67044855
0,27,1,1,0,4,6,1509537.95309196,4880850.04020315
1,12,6,3,0,1,10,2174481.07532177,4566720.06134543
0,25,3,1,2,7,13,2830519.17087429,6567538.71732031
0,18,5,3,2,6,16,2683109.51662873,3749740.2212139
0,18,3,3,0,1,7,1557491.92297192,5624309.40313086
0,40,4,1,1,0,6,1565903.12831734,4731511.35022145
0,17,1,3,0,5,9,2336765.06644546,8011606.44374663
0,12,3,1,2,4,10,1786524.13549888,9309690.50741346
1,27,3,2,2,4,11,2248771.08076307,6756968.39074484
1,28,5,1,1,7,14,2865095.78681313,2327252.99545604
0,31,6,3,1,6,16,1930548.33129728,7312117.52380057
0,29,6,1,1,5,13,2151122.2900907,5836548.97742023
0,29,0,3,2,5,10,1369122.30184207,7098813.15596052
1,38,1,2,2,5,10,1271395.0508129,5494742.07939902
0,17,4,1,1,0,6,1639822.81792669,4241006.10709635
0,30,2,0,0,2,4,1091181.46198669,3626702.58374431
0,18,2,2,0,0,4,1456525.53551253,4195554.73732004
1,17,0,0,0,0,0,976639.270105719,2435126.06233997
1,13,5,1,0,5,11,1945930.20092233,6570618.18729463
0,31,2,3,1,4,10,2493955.76035635,3800796.48387898
0,22,4,0,1,3,8,2281564.50268831,5289541.66899397
1,37,2,2,2,5,11,1667752.87529559,7818070.46112966
1,26,4,3,0,5,12,2721153.89928779,4832790.78719681
0,28,4,3,0,0,7,1523681.49349319,3221326.91218898
1,37,2,3,0,1,6,1453824.99557038,1713009.46400245
0,26,0,0,1,3,4,1728039.79971587,2973591.05731027
0,18,2,0,2,7,11,1391159.47933085,7519988.93628939
0,11,4,2,2,5,13,2200178.91384296,8856349.59128983
0,40,2,2,1,2,7,2211032.91369804,8047987.7077174
0,16,2,1,2,5,10,2131495.29736351,7903646.5664432
0,16,4,0,1,5,10,2315886.04198791,9764102.11608028
0,21,0,0,0,6,6,1987764.11961753,5581739.1884163
0,39,4,2,2,5,13,2100491.84244508,7567205.01192988
1,38,1,0,2,5,8,1990531.37372954,10792996.8458366
0,11,1,1,0,6,8,2082011.58847846,4433858.85430558
0,10,2,2,2,7,13,2202288.74803432,6264370.59608048
1,22,1,0,1,0,2,1064935.39573466,4668918.01881931
0,25,1,3,1,7,12,1908768.76105406,6870413.09446289
0,23,1,2,0,0,3,1207446.60626631,4256328.75025053
1,35,1,1,1,5,8,1172459.13013592,5306744.83280754
0,21,0,2,0,0,2,1372674.94142321,3918118.63601052
1,10,5,2,0,1,8,1439712.3389596,6747452.06001594
0,38,1,0,1,0,2,1242392.57960917,4268194.38298913
0,17,0,0,0,2,2,995959.423569989,3146571.28870941
0,26,6,2,2,4,14,2812469.44752755,5213892.19351595
0,23,0,2,2,4,8,1982332.61076019,4754931.5389583
0,35,4,2,0,2,8,1278822.02645802,4762643.89589797
0,26,5,2,2,4,13,1723840.46758121,7021732.65810491
0,14,1,3,1,5,10,1698696.32617981,742688.039863016
0,37,2,2,0,3,7,1418700.76342841,3712383.41606003
0,20,1,2,0,1,4,842342.898848239,3192015.94886012
1,19,0,1,1,1,3,784953.346641368,2818924.00120409
1,13,1,0,2,1,4,1296756.55954261,2652600.31447824
0,28,6,3,2,4,15,2537138.44066553,9685013.41313056
0,20,5,3,2,2,12,1923802.7582745,7189905.6974603
0,29,3,1,1,7,12,2902941.02864112,2436576.77363517
0,26,0,3,1,2,6,1154653.97020175,5398696.68328249
0,28,3,3,0,7,13,2494714.05292903,6385787.22474277
0,36,2,0,1,0,3,1556297.29486943,5164598.9838597
0,35,0,0,0,1,1,880248.887917387,4061492.17884234
0,26,4,1,0,1,6,1637387.41390812,3375489.75488977
0,25,4,1,2,7,14,2232858.63944265,10500447.5456696
1,26,4,3,0,2,9,1758876.38302717,4825776.49356976
0,12,1,0,2,5,8,1888083.64272449,4152940.97309431
0,29,6,3,2,1,12,2307296.44302541,5997170.65220894
0,23,2,3,0,4,9,1548820.83387344,11059441.3683798
0,32,4,0,0,0,4,1323977.83515963,2644164.42488456
0,33,3,0,2,2,7,1555510.87864258,7759087.6388422
1,26,2,1,1,1,5,1709700.79074732,3662964.03671368
1,36,1,3,1,0,5,1190440.79757998,4353556.52343954
0,29,3,0,0,3,6,1671302.97648705,6326637.11486305
1,35,3,3,2,6,14,2818483.22044077,5413771.65387356
0,30,4,3,1,6,14,2457783.45007578,8193705.25084976
1,29,1,2,0,1,4,1198977.33530629,3881847.41444931
1,30,4,0,0,3,7,1750620.35839301,4546205.7105376
0,36,4,3,1,4,12,2472286.48402934,7636415.65250465
0,38,6,0,2,0,8,2030351.01526767,6925233.93470352
0,25,4,3,2,3,12,2020331.97193913,4826235.86293727
0,23,3,2,1,0,6,1602145.5540314,3914392.60445963
0,23,3,0,0,0,3,1459361.64709853,3529391.70492221
0,12,0,0,1,1,2,1196366.60848814,3368544.4782878
0,12,0,0,0,6,6,1342279.20967953,4504320.80380357
1,29,6,0,2,4,12,1485571.7268925,7165753.79866014
0,20,3,2,0,0,5,1642911.16495085,7521961.70321295
0,15,4,1,1,2,8,1460147.84439655,2877592.35754668
0,29,0,2,2,3,7,1524390.13612904,3937577.74010123
0,13,5,1,0,3,9,1877798.55760281,4639548.05244825
0,20,5,3,1,7,16,2435089.86349585,7798630.09974873
0,28,0,2,1,3,6,1592565.52853764,7163141.99737962
0,32,5,3,0,5,13,2380697.16429287,9233719.54465097
0,31,6,1,2,0,9,1639699.91971182,5541796.7497845
0,24,1,2,2,7,12,2159850.13379227,4428931.61916723
1,39,3,0,0,6,9,1787523.75290854,1523515.46645528
0,27,3,1,1,0,5,1777112.66946845,6465382.79397525
0,40,3,0,2,3,8,1928636.70696877,8178569.0530613
0,32,5,1,2,5,13,2102545.57940777,9457487.33552904
0,30,6,1,0,4,11,2288347.73511904,6783242.72408264
0,18,4,3,0,3,10,2030552.87095562,4289086.45243684
0,13,2,1,1,1,5,1255965.33382744,5037744.68708678
0,12,4,2,0,1,7,1580707.92969802,4033767.33284704
0,25,5,0,1,1,7,1722525.06114217,6307079.43024701
0,31,2,3,2,4,11,2297199.96730416,7063973.92171947
0,17,5,1,0,3,9,2065122.91722339,7804846.43285178
0,31,5,0,2,4,11,1630895.59801864,1794235.03026639
0,22,3,3,0,4,10,2390678.47332652,8351957.82938952
1,28,5,2,1,4,12,2242848.71306502,3496383.4723886
0,22,6,2,2,4,14,2041097.05609433,8325580.27033547
0,28,4,3,2,7,16,2549831.54404465,9900525.82765987
1,34,4,1,0,2,7,2185259.63538686,4734239.02020688
0,20,6,2,1,6,15,3388727.78250096,8911239.08130371
0,19,2,1,0,7,10,2035871.92211689,4771535.54751874
0,25,0,3,0,5,8,1811505.50209738,1699582.66561946
1,20,6,0,1,3,10,1861788.89628827,6994979.19586015
0,40,1,1,0,0,2,1253206.26822886,2818032.4989694
0,24,0,2,2,0,4,1528279.17865206,6055781.81829598
0,34,3,2,2,1,8,1395235.41611391,5887550.41390734
0,36,6,1,0,6,13,2069529.74811975,6131660.41122937
0,30,6,3,1,4,14,2260445.74392063,5614360.7038827
0,16,2,2,0,0,4,1508277.84016991,4759901.73216463
1,25,5,1,1,2,9,2064199.79193572,7222646.91074449
0,15,0,1,0,7,8,1870727.58985032,6010874.6623861
1,39,2,0,2,1,5,1601687.02800134,5548426.40225993
0,36,1,2,1,4,8,2023498.49247019,5112103.5936749
0,32,6,2,0,6,14,3003322.89240858,9983000.3639887
0,25,6,0,0,2,8,2225427.07669095,3355755.11104075
0,21,4,1,1,7,13,2293924.33852666,8998186.22237278
1,34,5,3,2,0,10,2112127.27299489,7727952.70296472
1,38,4,2,1,1,8,1952101.29176303,7924437.81985535
0,18,0,3,0,7,10,2065163.58397129,6497435.26328566
1,19,0,2,0,2,4,1261998.47942984,4142049.27621939
1,35,3,2,0,7,12,2193010.89749012,8338669.99221771
0,11,3,1,2,6,12,1504083.96722196,5179155.70465758
0,26,3,2,1,4,10,2410794.6641462,5922671.59095409
0,12,3,2,2,6,13,2065686.93212713,10449217.9467024
0,16,6,2,0,6,14,2477038.40300751,7691673.26081722
1,21,1,0,2,6,9,1498637.13987987,5298489.76813838
0,21,0,0,2,2,4,1388431.69547453,2965517.02639926
1,39,6,2,1,5,14,1632816.63971096,6607391.85939715
1,12,1,2,2,1,6,1714052.16112215,3105621.33133404
1,37,4,1,1,2,8,2165946.3570804,5961198.69118635
0,30,4,3,1,5,13,2572798.41479748,8427249.42424608
0,31,1,0,2,5,8,1421291.07936552,1621514.98983594
0,16,2,1,2,6,11,2410569.91512078,6925018.3267434
0,16,4,3,1,2,10,1884237.28387993,7191401.54509305
0,31,6,2,0,3,11,1963503.62989673,4213149.76786109
1,19,5,0,0,4,9,1853197.42916943,2909016.03335759
0,30,1,0,0,2,3,1073501.70672695,4444742.15377344
1,30,6,1,0,2,9,1798072.62401515,7252613.09099614
0,20,3,2,2,1,8,2061028.86569267,7065822.89684564
1,29,1,2,0,2,5,1707539.1879114,3344957.47333999
0,36,2,3,1,0,6,1303492.18078273,6286520.87593283
0,10,5,1,2,2,10,1710524.05040604,3204525.45321491
0,32,4,3,1,3,11,2126182.45101324,5501369.70648088
1,36,2,3,2,7,14,2431775.45404456,4381732.73247707
0,38,0,1,1,0,2,1151162.64027359,4151010.99842404
0,21,2,0,1,2,5,1793786.98733229,5335217.83225815
0,30,6,1,1,4,12,1636098.08261472,6423030.3658248
0,38,0,2,0,1,3,1706858.77171902,3712205.48095286
0,26,3,0,0,4,7,1857392.34600841,4601748.35521362
0,12,0,3,2,0,5,1383288.56355423,4311892.33890596
0,21,5,0,0,5,10,2078704.95470957,6061517.29978569
0,15,4,0,0,3,7,1726976.38143249,5592683.2236356
1,23,0,3,0,2,5,1397202.05262855,4226534.17611355
1,33,0,1,1,5,7,1207788.48844805,6212923.80381888
1,17,4,3,1,3,11,2302545.9248245,8771656.86755548
1,18,5,3,2,6,16,2931708.02365831,5151951.2384007
0,34,3,0,2,6,11,2021258.29121523,3483903.19879024
0,29,3,0,1,5,9,2150908.29211117,6720405.68107533
1,11,1,0,1,0,2,1105163.95223243,3553204.1582612
1,34,2,2,1,3,8,1594648.30283988,5259775.10168746
1,31,3,2,0,5,10,1913022.16159417,8285784.68993822
0,18,3,1,0,7,11,1804378.11510138,3370674.18186695
1,13,4,2,0,3,9,1454108.38777676,5109858.58394881
1,35,3,1,1,0,5,1353028.10207677,4512016.38497439
0,16,5,3,2,1,11,2025672.51594474,6133332.39744896
0,30,6,0,0,2,8,1678552.06373333,7206934.11740199
0,35,2,0,0,2,4,1270900.85527548,6511817.79807522
1,38,2,2,1,6,11,1675935.84801474,1659695.38854066
1,27,3,2,2,5,12,2132960.53316173,5609937.43302201
1,39,2,0,0,2,4,1379535.84786716,2194275.86879249
1,28,5,2,1,3,11,2384177.95590452,3316142.53445565
0,26,4,3,1,7,15,2716783.00771354,6086495.25110219
0,40,6,0,0,6,12,2405568.68503837,4368845.3801132
0,31,3,3,1,7,14,1805629.34604244,8795912.16198615
0,17,2,0,0,0,2,1269244.49377644,2281118.77382056
0,38,5,3,1,3,12,1797780.50053877,6552879.78213192
1,36,1,0,1,7,9,1863536.55852508,4709794.80156805
0,23,1,3,1,0,5,1649716.64805965,5335996.16089884
1,13,4,2,2,5,13,2524225.31555994,5325561.85042575
0,20,6,2,0,0,8,1948819.32643392,8075668.97596164
0,22,0,2,0,6,8,2095726.88628904,5642470.98330975
0,24,3,0,0,5,8,1870309.76169407,5269680.59924263
0,12,0,0,0,6,6,1401743.2518335,7072096.60654534
1,13,4,2,1,7,14,2316238.85288105,3925997.83644806
1,18,0,3,2,1,6,1426799.84811605,1549854.28987162
1,27,1,1,0,0,2,1224604.16182616,919003.660881524
0,12,1,2,0,0,3,1548984.46670911,6421110.69232232
1,26,1,2,2,1,6,1425811.99290226,4156370.8395643
0,38,5,3,2,5,15,1763166.28680123,5114781.91643443
0,11,3,2,1,4,10,2345859.05075084,2385956.77186542
1,25,2,1,0,3,6,1750380.12400587,6645202.59709513
0,33,5,0,0,2,7,1152962.40612052,5266032.71227401
0,13,4,3,2,2,11,1958285.01851441,2792955.12632322
0,36,1,1,2,6,10,1695040.32353821,9347942.83275345
0,24,6,3,2,4,15,1966014.66328096,6115142.75839517
0,28,6,0,1,3,10,1908489.45182433,7977634.92777517
0,30,6,1,2,6,15,2564570.3773822,6487241.45241967
1,13,2,2,1,3,8,2084852.02425939,6228599.61011106
0,35,4,0,2,3,9,1806869.35958704,4843432.93139493
0,18,2,0,1,1,4,1553347.84618255,4350350.64616416
0,24,3,1,1,5,10,2591100.52807217,2982182.23113056
0,16,4,1,0,6,11,1910043.35193278,6409527.37649364
1,26,4,3,0,6,13,2551014.44067977,4337844.69183327
0,30,5,1,1,0,7,1344233.55624403,5365141.69503916
0,14,1,3,1,0,5,1272003.08832099,3851039.97909447
0,18,0,1,1,7,9,2083430.47904584,3399746.20685717
0,10,3,0,1,7,11,1598111.42801792,7562684.20739327
0,34,3,2,0,1,6,1519309.40695618,3590141.44461959
1,33,3,0,1,7,11,2644680.87933225,9285081.53811057
0,26,4,0,0,6,10,2383400.24095402,3977383.12600952
0,13,5,0,2,2,9,1766103.01767678,8631879.02949192
0,19,3,2,1,5,11,2303992.95576503,8166789.58846564
0,12,6,1,2,7,16,2993792.62728209,10479757.3625924
1,21,5,2,0,4,11,2281233.59271234,5870867.15993159
1,34,1,3,0,0,4,1512830.91528294,4044783.9560434
0,12,6,1,0,2,9,1552695.3862659,5977147.93359778
0,13,4,0,0,4,8,1418283.5614552,5162937.41375636
0,27,2,3,2,6,13,2334428.89665073,5549123.55554566
0,15,2,1,0,7,10,2299822.29466253,6870537.99095136
0,38,5,0,2,1,8,1529772.69141641,3673229.44393731
0,40,2,0,2,5,9,1719338.58996511,3763433.10143635
1,36,3,1,2,3,9,1696695.42069179,4992289.90112784
0,29,3,1,0,0,4,1246758.65018896,5188252.31895412
0,10,5,3,1,7,16,2538171.03709442,5869838.21459462
1,35,0,3,1,7,11,2505871.20148775,4423643.66211394
0,27,1,1,1,1,4,1176104.9395458,5446952.62119376
0,29,4,2,2,0,8,2170950.79366382,3458436.88353904
0,38,6,2,0,3,11,2288847.36581735,10496794.6388425
0,29,0,3,2,2,7,1268993.39676027,5371378.29938163
0,10,5,2,1,6,14,2173787.5885327,10222533.568139
0,29,0,3,1,2,6,1405994.52523113,4956905.20003568
1,19,6,1,2,1,10,2218555.18444421,8013443.55045548
0,25,5,3,1,4,13,2495545.3115903,9585110.40459619
1,35,1,1,2,3,7,1657670.54267877,6443692.73276976
0,36,3,3,0,0,6,2001547.50765064,2815586.60524763
1,39,0,3,1,0,4,1422643.26724135,4515432.84972023
0,12,2,3,0,4,9,1349204.46018111,6845844.28600747
1,30,1,2,0,1,4,1194105.75064324,4495456.37924118
0,32,3,1,2,1,7,1796217.71748432,5768628.33641204
1,17,2,0,2,6,10,1956264.08455049,6861885.94950831
1,23,3,2,0,6,11,2278315.44372081,3931166.6048189
0,31,6,0,0,5,11,2601210.48094694,9163119.87870515
0,13,4,0,2,5,11,1627640.61703762,7366920.6919198
1,38,3,0,1,0,4,1745862.11769506,5584234.67572145
0,12,5,1,2,1,9,1655410.14803284,5905114.73525322
0,16,5,2,2,6,15,2371886.91772982,7661801.35598627
1,10,5,2,2,2,11,2381120.22102499,7044012.12829372
0,37,2,1,2,4,9,2382693.15305154,5191673.70157077
0,20,3,3,0,6,12,1855333.97477908,9381867.71998364
0,37,4,2,0,1,7,1845894.77765227,4205882.55894145
0,24,1,1,0,1,3,1389256.04633991,3510021.38663646
0,27,2,3,2,7,14,2832274.9313932,5960514.46617625
0,36,4,3,2,2,11,1709775.84615251,5190031.02921177
0,27,5,2,1,6,14,2349039.04479405,4289285.61222747
1,18,6,2,0,6,14,2851832.17392174,7319949.52888999
0,17,2,1,2,1,6,1548779.64958698,2921273.82540498
1,36,4,2,2,2,10,2247872.66748308,7983225.61378166
0,11,5,1,1,6,13,2095260.55367474,8263263.69529622
0,16,3,3,1,5,12,1917855.11847234,6876609.06240284
0,10,4,3,0,7,14,2357186.37145971,8100886.76565142
0,35,0,1,1,4,6,1384843.32873248,3861285.46584574
0,36,2,0,1,4,7,1942979.81916068,6801753.9841361
1,36,4,3,2,1,10,1515496.40101217,6723353.004981
1,34,1,3,1,1,6,1808712.14569083,4346977.64357597
0,10,3,0,0,6,9,2037779.34034179,7176702.52624812
0,12,3,3,2,5,13,2185513.67024585,9844544.76223015
0,15,0,0,0,1,1,1205677.94954227,1205677.94954227
0,13,1,2,2,0,5,1404126.74088815,4892288.26669429
1,17,2,1,2,1,6,1584966.50336237,7352592.83348549
1,15,4,0,1,2,7,1789511.84102173,7770874.59395028
0,17,1,1,0,6,8,1423267.3926487,5534020.05261692
0,23,5,3,1,1,10,2013984.2849808,5600615.43492714
1,25,5,1,1,4,11,1638054.11307236,5975623.39239736
0,40,6,3,1,0,10,2083742.03614568,10466527.6472467
0,35,5,2,0,3,10,2186638.17992547,6206967.76765089
1,21,2,3,0,1,6,1970700.64185338,3405899.14694679
0,13,6,1,2,3,12,2278647.79871885,4589577.51620743
1,17,0,0,0,3,3,1190007.67614591,3101500.17169359
1,32,1,3,0,2,6,1608723.17158516,6204312.61745709
1,30,1,0,0,3,4,1808736.22516592,3699511.08025099
0,20,2,0,2,6,10,2744458.57738197,5333551.18499221
0,14,1,2,1,5,9,2003576.62298736,2825005.03696984
1,37,3,1,2,6,12,2240289.79745323,6705032.4218354
1,35,1,0,1,6,8,1910368.61710152,6969742.03443861
1,35,4,3,0,5,12,2536622.89045545,4585124.97741051
0,28,1,0,0,2,3,1237392.24711186,2324956.61831735
1,10,1,1,1,1,4,1523844.59858006,5132608.88454973
0,26,3,3,1,6,13,2368313.01123232,5541375.90437899
0,39,1,1,1,2,5,1832820.51267902,6143029.44743381
0,31,1,2,0,3,6,1577828.96280839,5093754.43983516
0,31,6,1,0,6,13,2836022.63076378,6540064.87034083
0,39,3,3,1,4,11,2444181.75446296,7859060.85166895
0,28,0,3,0,3,6,1761622.18084483,4642532.20852245
1,24,4,3,1,3,11,2531190.14135372,7121803.65697083
0,33,2,0,2,6,10,1859630.64692364,8154965.22546217
0,36,4,2,2,3,11,2038592.42656444,4844203.77542862
0,10,2,1,2,6,11,2473646.94910629,1153503.69855801
0,15,2,0,1,6,9,1988440.60320215,5244862.47352659
0,38,5,2,1,3,11,2580966.15541398,3189441.211322
1,29,0,1,2,5,8,1080050.30714575,6329693.74769731
0,36,2,3,2,6,13,1954555.67951338,8007100.1078679
0,25,6,3,2,7,18,2193402.82940527,7511803.88685562
0,26,2,0,0,1,3,976970.997028253,2501452.25549602
1,27,3,0,2,4,9,1479298.74287747,2332681.77410987
1,38,6,1,1,3,11,2160503.99141889,3589043.76938274
0,11,1,3,0,6,10,2276967.20309567,9356424.03747365
0,11,5,0,1,2,8,1214901.63716413,7126644.35807227
0,26,1,1,0,5,7,1642719.08391013,5604777.04977296
1,13,3,1,1,0,5,1510565.42342936,4080864.893415
0,19,0,0,0,3,3,1616358.88771961,4441081.35049422
0,26,6,0,0,7,13,2443765.61394684,5970265.25913608
0,11,6,3,0,0,9,1559346.92539892,5011277.09521376
1,40,6,1,2,1,10,2355432.65795937,3124663.93774945
0,21,2,0,0,2,4,1210133.62532137,2556690.2586989
0,31,1,3,0,5,9,1778518.71718109,3958082.07286777
1,12,2,1,2,7,12,1959728.36302498,4498068.60055171
0,29,3,0,2,2,7,1830035.40747384,4969720.45014867
0,30,5,0,2,1,8,2219670.15133611,5799944.88524698
0,37,4,2,2,1,9,1854518.89258802,7099961.95908784
0,36,0,2,1,1,4,1049587.83955711,4358332.9442028
0,20,3,2,1,2,8,1300811.61693888,4344520.3016241
0,21,4,0,2,2,8,2070695.47473909,5193424.66098442
0,21,3,2,2,2,9,1724927.3697637,8453925.82865259
0,21,3,0,1,0,4,1427704.7102437,4195188.82747251
0,13,4,3,1,4,12,2295125.3935905,4446486.54257335
0,17,2,3,2,7,14,2453536.76427414,7245204.57738861
1,30,6,0,0,0,6,1142762.65476347,5417308.07280767
0,27,1,1,2,6,10,2399271.27370457,5974446.28239643
0,29,1,1,0,4,6,1436089.24791648,5812245.13586755
1,34,2,1,1,1,5,1417726.17056462,5394408.67310843
0,21,0,1,1,6,8,2374892.26631048,7314408.01506818
1,21,5,2,1,4,12,1860853.1989348,4893541.51298226
0,26,3,1,2,4,10,2378693.5268645,8260069.02775395
0,30,3,0,1,1,5,1428517.56105636,7174381.17811234
0,15,1,1,2,4,8,2003595.81328092,8083965.33311091
0,24,0,1,2,2,5,1484508.85182872,2628922.53241446
1,29,3,1,0,3,7,1695864.25092386,4071282.9065013
0,19,2,1,0,2,5,1452753.10211447,5109635.11327455
1,37,6,2,1,4,13,1977881.82729205,8811724.25606766
1,35,0,3,0,3,6,803736.283785991,5869725.7958698
0,32,0,1,2,7,10,2300294.20307482,3929464.66142485
0,30,5,1,2,2,10,1775274.6857978,6657929.48885337
0,12,5,1,2,7,15,3082875.29573055,8196268.43088388
0,21,1,2,0,2,5,1116177.84778844,364460.549330667
0,23,1,3,1,3,8,1657863.75207331,4993362.65191028
0,27,0,2,0,5,7,1686973.83600695,5955015.27462313
0,22,3,0,0,7,10,2153415.51667535,8867497.75986319
0,38,3,3,1,1,8,1139250.1127028,8586961.55290264
1,25,4,2,1,7,14,2467130.07951438,4325380.83043664
0,24,2,0,0,7,9,1834121.61803299,8219971.72985026
1,10,4,2,1,4,11,2225056.02018159,8039169.44206092
0,29,6,3,2,1,12,1637033.44877569,3656866.13159425
0,23,1,3,2,1,7,1828462.39221689,5821872.66268307
0,10,6,3,2,2,13,1371779.77348511,6014332.40776739
0,20,4,3,1,6,14,2102825.55939607,7855162.08073911
0,33,1,1,2,2,6,1698977.90272202,3610669.58067361
0,31,5,2,1,7,15,2750783.25016941,10336097.826668
0,40,5,1,0,4,10,1684299.6469239,4842352.13165298
0,26,4,3,1,4,12,2563611.14624314,6886617.35538327
0,40,1,1,1,1,4,1646189.46074922,3191897.93096464
0,13,6,1,1,4,12,1647214.71250249,6609098.54761062
0,34,0,1,2,3,6,1612125.36388722,7349643.21945906
0,11,6,0,0,3,9,2088605.59378888,6959961.20402782
1,35,4,0,1,0,5,1729376.03103745,3750557.84887245
0,38,5,0,0,0,5,1502832.39639086,4886418.66016306
0,35,4,3,1,3,11,1761233.14692009,7538861.36310287
1,11,0,2,1,0,3,1192307.27408078,2801601.68952305
0,25,1,1,1,5,8,1794356.15181505,2853273.46763327
0,31,1,2,2,1,6,2100441.51274524,4800001.00962027
0,28,0,0,2,2,4,1545302.52398856,4585816.32260362
0,22,1,2,1,3,7,1959864.4927365,5231427.81935985
0,11,1,2,2,3,8,1985867.07880493,4043401.70551862
1,10,0,3,1,0,4,1514076.58843493,1836128.80722035
0,11,5,3,0,7,15,2074948.85451355,9025718.70580544
0,36,0,3,0,6,9,1690463.36914683,6657873.65863607
0,23,2,3,1,5,11,2133818.6908164,3024401.40611439
0,18,3,3,1,2,9,2309202.07894798,5307622.22848342
0,11,4,2,1,1,8,1504853.15128876,7260879.16093835
0,31,6,3,1,6,16,2776743.97230064,7022676.59577383
0,29,6,2,0,6,14,2347036.87265036,6834644.62279358
1,30,1,0,1,0,2,1267694.37345952,5550253.51556944
0,22,5,2,1,7,15,1475781.5170526,9865028.16595009
1,36,6,2,1,5,14,2568775.17379539,5663157.9800422
0,19,1,0,0,7,8,2060578.36361936,4993258.4060135
0,14,6,1,0,2,9,1737785.89866178,6013769.21541142
0,34,1,2,2,3,8,1834997.02061267,3831837.79949126
1,39,5,0,0,1,6,1840837.58421117,6933792.98722232
0,31,5,1,2,5,13,2055487.19963277,6726339.94208094
0,12,2,1,2,3,8,2004248.31419443,6161562.69909916
0,19,6,2,2,6,16,2908405.34777003,6579173.78968942
0,33,6,3,2,7,18,2014498.87530511,6499147.50691951
0,22,6,1,0,2,9,1857791.00210215,4382201.92211592
1,19,5,3,1,0,9,1642942.82541353,2948252.55013393
0,32,5,3,1,2,11,1924940.10954036,5570825.2360125
0,17,3,0,1,0,4,1330433.93514226,3075687.53084876
0,36,4,0,1,6,11,2348906.34919751,6801725.83255848
1,13,3,1,2,1,7,1493341.3498905,6021567.17996302
0,34,1,3,1,0,5,1470949.08018867,6254969.99850457
0,18,3,1,2,6,12,2067230.19317547,4062823.1953457
0,27,4,1,2,0,7,1712961.88561723,3239289.27841769
1,14,4,1,0,2,7,1615240.0738721,4823088.49567327
0,37,3,1,1,0,5,1481435.11777484,3242754.67556401
1,17,3,0,2,6,11,2074011.55499876,5298867.7073975
0,12,4,3,0,3,10,2227610.20827483,8221672.87448244
1,36,4,1,1,4,10,1876708.73821186,3297541.56060685
1,29,3,1,0,2,6,1371367.23950584,4171178.64711661
0,27,0,1,2,0,3,1230983.21414864,3487377.63376197
0,39,4,3,0,4,11,2082807.55338277,5279669.42436258
0,39,0,2,2,5,9,1639626.03226983,5238224.63652394
0,26,6,3,1,6,16,2641670.41995182,4169785.35146242
0,22,0,3,1,3,7,1374730.91899965,6043519.14980266
0,14,3,1,2,4,10,1613185.27223526,4576167.46588935
0,16,0,3,1,7,11,1800732.27193331,5624655.3568933
0,17,2,2,0,5,9,1909917.64682701,3808214.9920799
0,15,2,3,0,1,6,1667902.83334699,4358586.54185897
0,28,3,1,0,4,8,1872307.16125838,2053681.89963956
0,13,0,2,2,6,10,2492360.14518674,4482491.57839132
1,29,6,1,2,6,15,1920987.12055838,5667448.54413425
0,29,2,2,2,1,7,1513539.52376485,5296096.87821273
0,34,4,1,2,2,9,1512158.75648938,4379207.22231201
0,24,3,0,1,6,10,1595649.72181807,7367948.36670039
0,20,0,0,0,6,6,1780770.58845891,6996821.0991322
0,38,3,1,0,5,9,2054881.44429373,6252959.25920554
0,30,0,2,1,0,3,961965.020924905,5666286.57713595
0,10,5,3,0,7,15,2468325.72741599,7101960.18182133
0,17,4,3,2,6,15,3023712.93416379,8247588.1521219
1,22,4,3,2,4,13,2328127.94285848,9796493.87127585
0,40,0,3,2,6,11,2047543.05502045,6914789.06053903
0,15,6,2,1,4,13,2800455.87300962,5752826.16669344
0,33,4,2,2,4,12,2279855.50969197,3632558.73238155
0,31,0,0,1,3,4,1241806.2744602,5426827.45667062
1,19,0,1,2,4,7,1965680.04061592,7190070.22596881
0,26,5,1,1,2,9,1791447.72761724,6205853.95027824
0,13,0,1,1,3,5,985877.357088422,5169211.88521818
0,35,6,2,2,5,15,2406672.80095269,9512799.35822592
0,18,1,0,1,4,6,2083387.05059805,5299493.33354501
1,32,2,1,2,6,11,1623418.25462763,5413805.69758984
1,40,2,2,1,1,6,2168424.36955569,1420982.99168641
1,25,5,2,2,0,9,1504908.78090708,2984510.63897004
0,26,2,3,0,4,9,1935048.0761807,7282184.84292873
0,23,2,1,0,2,5,1695610.08176858,5015132.19417884
0,12,2,0,2,1,5,1584338.03860348,3639004.01570136
0,18,2,2,1,2,7,1237469.84746253,8636003.82203365
1,38,6,1,0,2,9,1359592.1342693,5324666.33833245
0,21,4,3,0,3,10,1985688.88036791,7752442.90601502
0,19,0,2,1,3,6,1261842.14264709,2105781.25929695
1,26,5,3,0,2,10,1943421.07538039,1957717.86612154
0,30,6,0,0,1,7,1543526.04461679,4154773.8581773
1,33,3,3,1,0,7,1396659.17647975,5980384.18640963
0,38,2,2,2,5,11,2748711.73255301,8307899.38293071
0,25,0,3,1,6,10,2228504.18188158,4697487.24691623
0,21,6,0,0,4,10,2977228.81397145,6554727.05523633
1,30,5,1,1,1,8,2106807.88384645,5569568.21622477
0,14,3,0,2,4,9,1871623.64542532,4916279.87938021
0,22,1,3,2,0,6,1639293.0264876,2152234.81600958
0,34,6,0,1,3,10,2101587.07725432,6525492.49353042
0,39,1,1,1,2,5,1579334.16991351,6537830.1715098
0,11,6,0,0,1,7,1464911.69228324,5169764.06815547
1,27,1,0,1,5,7,1771435.05694995,3396884.89179073
1,28,4,3,0,7,14,1545962.19162698,6600294.52245063
1,15,5,1,1,0,7,1835457.51310934,5613851.11861927
1,22,6,3,2,4,15,1517131.44140958,5575585.12844852
0,24,1,3,0,4,8,2266766.9619449,9279595.96520399
0,21,4,0,1,0,5,1650449.04734751,4616631.12990463
0,24,4,2,0,3,9,1375006.2465306,6165253.957395
0,14,5,3,0,1,9,1993143.23120423,7790405.36938139
0,17,6,2,0,4,12,1450752.10644732,9035295.46176978
0,12,3,0,2,6,11,1312496.8421965,6002615.20419158
0,29,4,0,0,1,5,1628968.80986642,2723102.62139888
0,26,5,2,1,7,15,3291923.12504565,13846753.4454746
1,21,6,0,2,3,11,2541843.65134174,4690783.03850541
1,29,5,3,0,1,9,2254114.94864257,7220480.41919439
0,39,3,0,1,3,7,1601370.45494919,5960898.47293312
0,36,1,1,0,5,7,1445663.57930069,5060800.85938972
0,13,1,0,0,7,8,1659944.26620535,2418415.69057568
0,12,6,0,2,7,15,3212066.58319346,9199907.90218018
1,21,6,2,0,1,9,1647604.61910441,5097805.95909
0,12,4,3,0,6,13,2770036.43270143,8899495.76291781
0,39,4,3,0,1,8,1383024.86529793,5501333.41006786
0,27,6,3,2,4,15,2708369.16568097,9648723.9738159
0,13,2,1,0,5,8,1596590.68378631,4767373.68736682
0,37,4,0,0,6,10,2242218.79977291,3700940.07198056
0,23,0,2,1,4,7,1910672.01626817,1854499.38915892
0,35,4,0,0,2,6,1965824.43698387,1453942.44988184
0,16,3,2,1,0,6,1241991.02551915,1298919.7114526
0,18,1,1,2,2,6,1452460.79161644,4241395.60853484
1,23,0,0,2,2,4,1475885.10173472,5260871.03267579
0,32,6,2,0,3,11,2491317.19045099,5826155.48528186
0,21,1,3,1,0,5,1329359.91123386,4376683.78174898
1,10,2,0,0,6,8,2017858.01248139,6008910.61353473
1,19,3,1,0,2,6,1455718.16559573,5689800.53611941
0,16,4,3,1,1,9,2074821.59332526,2082558.14276645
0,29,5,2,1,4,12,2120188.43125195,8375811.05022621
0,40,3,1,1,0,5,1607231.84947112,2594866.95658161
0,40,5,2,0,3,10,1711877.13395655,5612225.01763665
0,17,0,2,0,0,2,1007038.06324556,3335642.28550119
0,31,4,2,0,0,6,1610596.58370321,3184337.59886979
0,21,5,0,0,0,5,1259347.87746022,7225998.30717512
0,33,6,0,0,5,11,1834368.08299371,5518973.14227437
0,14,2,1,0,7,10,2293382.62899517,7334154.04842579
0,14,3,0,2,2,7,1458737.11971189,2971042.97787544
0,32,0,2,2,1,5,1648103.4265577,3003515.20517847
0,19,6,2,2,7,17,3226345.30299724,5829301.66868612
0,40,5,1,0,3,9,1870713.52091808,7612017.60745534
0,22,6,3,0,6,15,1783309.56411229,2056040.73881786
1,33,4,1,2,3,10,2202464.91482909,7076133.61970341
0,31,6,3,2,1,12,2471149.3690046,7826568.96582913
1,27,1,1,0,7,9,1496826.35263159,5101020.9302364
0,25,5,0,2,7,14,2307051.12421553,4782754.83749752
0,11,1,0,0,6,7,2139822.78671174,7825989.313035
0,19,4,3,2,6,15,3084614.26416985,6018690.91921531
0,17,3,3,1,3,10,1856001.9214954,6665262.90734681
0,11,6,2,1,6,15,2582350.82761994,8662246.23061248
0,10,1,1,1,7,10,2094019.31653515,5793841.11172001
0,39,2,1,2,3,8,1433169.01956727,4649454.91520805
0,26,1,2,2,6,11,1890044.93491429,8058561.95079731
0,40,3,2,1,6,12,1917203.63198033,3059316.50342006
0,20,5,0,1,1,7,1685916.9193387,3706657.78652335
1,26,5,3,0,6,14,2796093.58938911,8885402.48494393
0,20,1,2,0,0,3,1747063.94395345,7372670.27243272
0,24,3,2,2,1,8,1298174.48492664,4855884.18091736
0,27,2,3,1,0,6,1705521.75459951,2673539.67159006
0,24,3,2,1,3,9,1333207.07490196,6804042.00570546
0,14,6,0,0,5,11,1968449.4585662,9386095.39072354
0,30,1,2,2,2,7,2070886.81137546,5874868.24744924
1,22,3,2,0,2,7,1935079.68684965,4026959.90372831
1,21,1,2,2,6,11,1613770.23429913,4990058.47523913
0,26,3,3,1,1,8,1724828.8096523,3343606.64300145
1,23,3,1,2,7,13,1881700.45664749,4784731.80824167
1,39,4,1,1,6,12,2936891.52798458,4277374.40656059
1,17,6,0,2,1,9,2040593.08138582,6743955.99817586
0,14,4,3,2,2,11,2753992.08819208,5541965.38436052
0,35,6,2,2,2,12,2099455.14722149,7474518.14743359
0,36,5,2,2,1,10,2112204.76755059,1703756.49970164
1,27,6,1,1,1,9,1453573.83493605,5623977.37495528
0,28,0,0,2,6,8,1605369.91281661,5160755.78444587
0,39,6,2,1,2,11,1932884.46662642,6828326.51119222
1,25,2,2,2,1,7,1955445.50679351,2278623.78536578
1,13,2,3,2,7,14,1828912.33483452,4090274.42650163
1,19,2,3,0,1,6,1405681.07585984,2229506.03322597
0,29,6,3,0,5,14,2224563.99513753,8051934.72459845
1,37,1,2,2,3,8,1837999.77629132,6629705.43326106
0,31,6,0,2,4,12,2225254.48738864,4314177.369786
0,26,0,2,2,6,10,1883557.21273343,3996133.40305814
0,30,2,1,1,7,11,1695409.04568509,5129305.77012333
0,36,1,2,2,0,5,1696291.63079949,6116298.50527436
1,36,0,2,0,0,2,987675.187724788,5374230.63307153
0,26,4,0,0,7,11,1848986.30041299,6066733.05262922
1,24,1,1,1,2,5,1501878.67616173,3997956.42400309
1,40,4,3,0,2,9,1773643.57479599,4611725.73997126
0,19,2,2,0,2,6,1390395.46781631,3620757.88615069
1,18,3,3,1,6,13,1681659.37377876,9552001.3539358
1,16,4,3,2,5,14,3085736.52816334,8883275.49778417
0,26,1,1,1,5,8,1703905.64972856,6061321.14827981
0,35,6,0,1,0,7,1918063.51979738,5592710.3886105
0,35,5,2,1,5,13,1584937.57256116,4223718.60266171
0,32,4,1,0,1,6,1607395.65119171,5541389.31901034
0,22,4,3,2,4,13,1761820.52545197,5778358.27857022
0,34,5,0,1,7,13,2592738.83344727,8163097.49290161
1,29,1,3,0,6,10,1724418.81007809,2823248.24358566
0,16,4,0,0,4,8,1806195.98939583,4465052.59650572
0,17,3,2,1,0,6,1215680.79520543,3126625.8933976
0,19,4,1,2,0,7,1454425.95109231,5808394.67693588
0,28,1,2,1,1,5,1638265.82934184,6725716.40011639
0,19,2,0,2,2,6,1377263.73211672,6344262.56038102
0,19,1,0,0,4,5,1885907.43937912,6707065.74374222
0,31,3,2,2,6,13,1890143.82764215,6982716.58536519
0,10,1,2,1,0,4,1302032.99686658,5007097.19348097
0,26,2,0,0,1,3,1297870.73108495,5162043.19342132
0,23,0,1,1,7,9,1642251.08872293,4395429.93785041
0,36,4,1,0,5,10,1795150.91819782,7170596.71379004
1,34,0,1,1,6,8,1827195.32095502,7462128.95154148
0,35,4,2,0,6,12,2798065.4731386,6228653.17362265
0,26,4,3,0,1,8,2226863.60974529,4485912.59722581
0,13,2,0,2,6,10,2239370.53988219,6071533.87644025
1,16,0,3,2,6,11,1168120.68725819,6611034.95324199
0,22,6,0,1,1,8,2355812.46967647,6768556.29003343
0,17,4,2,0,4,10,2264838.62035232,6611165.00023198
0,18,4,0,0,5,9,2484591.5774595,6508376.26003268
0,29,1,0,2,1,4,1296472.20954543,5571589.73402039
0,31,6,2,1,6,15,2530538.51361986,5526161.35666539
0,24,5,0,0,6,11,1972627.44758968,6719726.3348232
0,27,0,0,0,2,2,1504003.49536136,3773694.18906329
0,18,6,2,1,4,13,2742468.96455246,3762249.1306462
0,17,3,3,0,0,6,1909076.22174049,2815477.23136343
0,20,1,0,2,2,5,1505356.53028479,2561651.88004165
0,22,6,0,0,1,7,1651147.78092026,7859306.62823082
0,21,3,0,2,5,10,1811834.86522006,6832253.47634898
1,12,6,0,2,3,11,2539715.95435848,4846354.01774167
1,21,1,3,2,7,13,2818044.23126369,2853909.49531521
0,19,0,3,1,7,11,2392401.90530073,4463095.63228629
0,22,4,3,1,2,10,2276917.30160222,9199906.6153844
0,36,4,0,0,7,11,2340450.03283736,1542187.07949624
0,24,0,0,2,7,9,2145030.25991497,7162456.97105988
0,30,3,0,2,4,9,2055821.94825724,9650924.17866195
1,39,4,1,1,5,11,2162753.87127278,9503803.19371283
0,28,1,2,1,2,6,1574523.26965673,2276674.50862916
1,25,3,1,2,6,12,2301032.52402972,6822031.81130699
1,39,6,0,0,2,8,1794896.32929643,7979096.91487348
0,19,0,0,2,0,2,1233476.57407193,4844456.86585368
0,11,5,1,2,4,12,2571249.22358621,5710480.17124545
0,21,0,1,0,0,1,1353978.91270001,2707450.42045687
1,39,1,1,0,1,3,792108.36746525,3934682.72123016
0,19,1,3,0,7,11,1423917.82945828,5969500.74118888
1,14,1,1,2,0,4,1828951.60092463,2949778.6581818
1,33,0,2,1,1,4,1781644.75810082,1413445.98218917
0,37,2,0,2,3,7,1841445.46267693,1783220.08773629
0,22,5,1,2,5,13,1903837.32313764,6798944.45741798
1,40,0,1,2,7,10,1935998.16326271,4543758.9229293
0,33,1,2,0,2,5,1670684.26671348,5175006.99274722
1,10,4,1,2,6,13,2318781.29498992,10526758.5203332
0,10,0,1,2,4,7,1874794.31984983,6191838.25118642
0,39,0,0,1,0,1,1585453.40093719,1853114.84903535
1,37,2,3,2,4,11,2119400.16160107,4960817.75365966
1,13,2,2,0,0,4,1538131.22860903,3129870.53508596
0,18,6,3,0,1,10,2049222.16949166,7951454.50568613
0,23,2,1,1,2,6,1212194.07336261,4757423.77072105
0,11,3,0,0,5,8,1774873.11424754,5220222.73259189
0,27,2,3,0,4,9,1784648.57713423,7504299.97257636
0,20,0,0,1,5,6,1192843.96234829,3427726.67186079
0,38,4,1,2,7,14,2400436.64785773,3863196.20744077
0,10,0,1,2,1,4,1407922.70592712,1748050.71745073
0,10,2,2,0,3,7,1355703.75840934,4744756.49542687
0,29,1,1,0,7,9,1623184.97188819,6730758.61488257
1,27,4,3,0,0,7,1885976.03329472,5863776.17302702
0,36,3,2,1,2,8,1658185.48800296,4998853.04816947
0,26,0,3,0,4,7,1879630.11816814,5446949.53760882
0,34,0,2,1,4,7,1397875.82850822,6328091.18070916
0,10,3,3,2,2,10,1998968.78217272,7595465.46310297
1,22,4,1,2,2,9,2277591.54059683,4808563.24512129
0,13,0,2,0,0,2,974374.341313576,5870478.69266999
0,30,4,1,2,5,12,1885191.52133554,6065804.58611479
1,11,2,1,1,0,4,1466773.04550329,2159781.93682171
1,13,5,3,1,5,14,2407901.79827631,11882686.6171639
1,12,2,0,2,7,11,1560759.31198782,10382739.77279
0,18,4,3,0,7,14,2880783.43946286,5210789.46770925
0,11,6,2,1,4,13,2404656.12772036,4638805.74807141
0,35,0,3,2,5,10,2072980.1106904,7095585.746353
1,27,3,0,1,2,6,1654562.01183042,3627070.74895397
1,18,3,1,0,1,5,1185886.17786506,3322398.84486194
0,25,0,2,2,3,7,1490060.17811741,2063216.72504099
1,27,2,2,0,3,7,1647542.79191938,4225112.35450767
1,33,4,0,2,0,6,1113719.58413053,5551983.13504582
1,39,1,1,2,3,7,2008057.99206153,3077572.32000266
0,32,3,2,0,4,9,1517492.83756584,6154151.35910732
1,22,3,2,2,4,11,1718344.7204972,6543790.79630604
0,38,6,0,1,2,9,1938581.82815705,4091598.79280731
1,29,2,2,2,7,13,1725948.00810944,6385794.42761442
0,18,3,0,0,2,5,1922370.90956377,4811674.45833058
0,11,2,3,0,1,6,2067427.36580825,4690441.56443757
0,40,4,1,1,5,11,2071405.39990191,7533021.09145078
1,18,5,1,0,6,12,2092265.22907104,5668706.86388698
0,23,3,1,2,6,12,2668129.792061,7431409.93219239
0,29,3,3,1,5,12,2938028.17054737,5545763.37180722
0,38,2,3,0,0,5,1385124.3594167,4002712.55416694
0,37,1,1,0,7,9,2435556.6013872,6828403.52457455
0,16,3,1,0,6,10,2147934.92593996,6807585.07790381
1,33,3,1,0,2,6,1314021.51511637,4279705.22593949
1,21,1,0,0,4,5,1456256.98313295,3933211.43705939
0,27,3,2,0,1,6,1046075.68146855,5155872.3301469
0,21,2,1,0,3,6,1724889.79930607,3998372.77403548
0,12,6,0,0,3,9,2026608.01440076,5229224.03473689
0,24,5,1,0,2,8,2597526.24999892,5699581.83905451
1,26,3,1,0,1,5,1538732.35610305,5462543.01348112
0,36,5,3,2,6,16,2334255.95098391,11403894.6943102
1,30,0,1,1,2,4,1185110.67759601,4684669.29146884
1,23,6,3,2,0,11,2565316.01670022,6845487.83465085
0,19,2,1,1,0,4,1477182.09953477,4753981.7918394
1,30,3,2,2,6,13,2063586.74333747,5766826.6942272
0,32,0,2,0,6,8,2272074.13334659,5120177.51293084
1,14,1,2,0,0,3,1008033.53076483,1641858.63707147
1,17,0,1,2,7,10,1741683.12864293,8797205.76742116
0,15,4,1,2,5,12,2221080.15665895,7836317.4686496
0,27,3,1,0,5,9,2150146.13281957,7205807.08313715
0,40,1,3,1,0,5,1774370.03477415,6024521.6108841
0,29,5,0,2,0,7,1248548.55468339,8320500.29307871
1,22,1,2,0,7,10,1989859.41926573,7027524.52756645
0,15,6,1,0,4,11,2010566.05687994,8848624.92750463
1,39,3,2,2,1,8,2074376.709271,7321795.50480304
0,14,1,2,2,1,6,1486427.1200904,4686919.63612715
1,24,6,0,2,1,9,1964361.92796696,8815006.52299316
0,24,1,1,2,5,9,2310715.90217389,6291250.25983879
1,28,0,3,1,1,5,1737597.8476756,1691796.2840965
0,17,2,1,2,4,9,2056135.55799832,3549629.21220897
1,26,5,0,1,0,6,1432250.09128976,4862076.91937756
0,40,3,0,2,7,12,2539360.96302466,7666323.86385498
0,13,4,2,1,1,8,1918466.54147159,3629167.58528887
0,10,6,0,0,3,9,1706627.4701366,3119761.30216488
0,25,4,2,1,4,11,1859470.45655943,9339209.72513788
0,18,3,0,0,0,3,1519208.08019306,1810483.81160847
0,33,1,2,1,0,4,1395884.62384484,2878968.58199578
0,20,4,3,0,3,10,2666172.63711366,6584960.54345299
0,30,0,0,0,4,4,969874.19439275,3738616.63671372
1,36,4,1,1,5,11,1913130.45305291,5294481.05086554
0,13,6,3,2,4,15,3496985.52210032,3446145.58402852
0,17,4,0,0,5,9,2014792.98629293,7662695.60480277
0,21,4,3,2,7,16,3088520.15721868,8556469.86769365
1,21,1,3,0,7,11,2288758.66366582,8235805.6008955
0,34,6,3,2,3,14,1925142.45965528,6697986.31756344
0,40,5,2,0,3,10,1454595.56696673,9490917.0393234
0,23,5,0,2,0,7,1635974.03111422,5723345.80522785
0,20,4,3,2,3,12,1992257.06872279,7767108.15251803
1,38,3,1,1,3,8,1788762.16112728,851818.32195511
1,18,4,1,2,2,9,2297236.08218702,8519193.27286892
0,27,3,1,1,1,6,1641909.404151,5357363.9961455
0,22,6,0,2,0,8,1794806.77637146,4572248.1639791
1,30,2,2,2,4,10,2559390.40121573,6529664.01464377
0,18,5,1,1,2,9,1911146.882528,7493556.23146702
0,30,6,3,2,3,14,2414346.03367995,9895332.62061204
0,33,6,1,2,4,13,2337170.9799785,7441786.25266927
1,40,5,0,2,4,11,1996281.44616465,6454347.38340389
0,35,4,2,0,5,11,2767356.50924641,897439.494975353
0,23,5,0,2,1,8,2058695.77387111,5872666.99272217
1,19,2,1,0,5,8,2004787.53519583,5753067.75117393
0,27,4,1,1,5,11,1954692.86701076,7092315.29291546
0,30,2,2,0,7,11,2420850.10160655,5514264.97615176
0,27,4,0,2,1,7,1391424.97143024,3010068.42480476
0,12,0,1,0,1,2,976436.566996951,5701964.99722094
0,35,3,2,0,0,5,1773131.85293087,3600351.98933346
1,27,6,0,0,2,8,1701605.69068295,7904089.53429215
0,36,2,0,0,7,9,1856781.32443182,6758302.32436892
0,25,1,1,0,6,8,1453102.50145688,4087515.03806592
0,27,1,3,2,5,11,1482810.19461395,7080758.69844823
1,12,5,1,0,0,6,1984894.46867992,5348831.26718218
0,39,2,3,0,1,6,1773804.37176089,6014266.77971552
1,28,2,0,1,1,4,1512990.00532752,3422955.72287571
0,39,1,0,1,5,7,1459445.53671663,7396508.33264786
1,32,4,0,1,7,12,1879724.98699314,2820432.06762745
0,16,3,2,2,6,13,2127862.70634208,5684302.97838275
1,34,0,0,1,1,2,1033440.38078068,3948927.83721296
0,17,4,1,2,1,8,1494081.47261434,8551843.38597469
0,28,4,0,0,5,9,1976848.59628118,2975077.25490274
0,38,0,2,1,7,10,2215014.18315279,7474997.67031327
0,16,1,3,2,3,9,2118568.38947147,4758112.63225526
0,36,3,3,0,7,13,2369325.32353158,7772606.05279096
1,12,3,3,0,3,9,1900849.85880529,2020233.49227897
0,22,6,0,1,0,7,1637864.70788805,7640983.9192767
1,37,5,3,0,5,13,2532595.11518167,8872935.08204201
0,39,2,1,2,2,7,1687469.32777099,5166212.3106852
1,37,0,3,0,2,5,1486997.69731025,2639838.30732359
1,27,0,1,1,1,3,1346221.98137777,1665721.59794228
0,36,4,3,1,1,9,2379787.50873836,10405542.3091862
0,25,3,2,1,6,12,2710886.41218606,4313639.64897634
1,20,5,2,1,2,10,1883750.55738995,5135230.40544877
0,11,2,0,0,0,2,1009284.57871939,5002883.99315986
1,29,0,3,1,3,7,1829895.74426756,6033847.34474822
0,22,0,0,2,6,8,1409771.72415126,2623373.52034035
0,16,3,1,1,2,7,2045342.34225027,4548766.17516791
0,39,3,3,2,1,9,1664987.63807107,4083557.72295728
0,36,4,2,2,5,13,2755130.74883274,6730436.9270851
0,21,4,2,0,3,9,1750500.8533709,6419585.83319469
0,18,2,1,0,3,6,1714370.7015802,5265776.79719484
0,15,0,2,1,5,8,1354484.83676586,5818955.57885533
0,21,3,2,2,5,12,2007380.08977997,7579508.22142763
1,39,2,1,1,7,11,1798418.85397323,5985596.57090318
0,37,1,2,1,2,6,1319317.13550101,6153278.07479369
1,27,6,1,2,1,10,2090161.5489073,8297123.34615281
0,27,0,2,2,3,7,1566083.87643915,5898465.75609016
0,35,5,3,1,0,9,2104888.3003211,2337393.20322815
0,34,4,0,0,5,9,2270844.78078767,6892351.41457918
0,28,4,0,0,2,6,1316852.44654884,4980323.28630814
0,13,1,1,1,2,5,1055985.17917513,2442524.88152712
0,27,4,2,2,6,14,2884899.03686739,3704596.20083836
0,32,5,3,0,6,14,1943001.10032147,4278870.33213732
1,40,6,1,2,0,9,1887700.28277128,5501846.29449472
0,34,4,3,2,6,15,2114841.50757401,9085976.50632137
1,27,4,1,0,2,7,1445608.49291693,5972093.20765147
0,14,4,3,2,1,10,1999885.46403065,6435442.29157787
0,36,4,3,1,4,12,2194230.78014536,7677911.53784152
0,28,3,2,2,1,8,1542969.9867523,6433223.95781452
0,29,1,2,2,2,7,1935021.2585794,6945086.99773035
0,10,5,2,2,7,16,2536493.3669576,5169072.73288325
0,18,2,0,1,1,4,1524663.60438709,6256665.90079212
0,10,6,2,1,0,9,2039057.64321005,4892710.80817462
1,19,4,2,0,4,10,2485252.41456066,5800519.17770171
1,36,0,0,2,3,5,1327698.84605588,5165198.58565403
1,12,5,1,1,2,9,1426346.22259448,7413930.07698195
0,36,3,2,2,0,7,1660406.61453656,2765149.91163551
0,23,2,0,2,6,10,1787337.19913219,7150573.01771221
0,29,4,0,1,0,5,1617601.93506713,2889963.29858591
1,28,2,3,1,4,10,2034109.30797233,4668726.99164655
1,39,2,2,0,0,4,918319.091256091,4747759.17579121
0,27,5,3,2,7,17,3372800.00791895,5008314.83682097
0,35,5,3,0,1,9,2226751.97702008,7208767.5338791
1,21,2,3,0,2,7,976533.674819619,5892069.4690893
0,28,5,2,2,1,10,2123302.79885079,4653417.04189134
1,34,6,0,0,4,10,2296653.36686046,6445542.36906377
0,38,2,3,2,7,14,1862606.78868662,8545216.44608731
0,15,3,2,1,4,10,2129745.52275877,4127371.13318769
0,18,3,2,1,0,6,1479326.60228999,6456064.8660995
0,37,0,2,1,4,7,1884545.34529926,5281475.29801718
1,35,1,2,1,4,8,1763487.50406071,3111759.08335888
0,12,2,3,1,1,7,1476691.40789591,4460724.88876342
0,37,6,3,2,3,14,2057010.8984534,7817728.18847912
1,26,1,0,1,0,2,1449923.03877259,3144735.77103696
0,34,4,1,1,5,11,2320675.58432885,7601574.86220568
0,12,6,2,0,5,13,1805380.40880521,8386683.22384056
0,35,2,2,2,5,11,2790546.30608142,7001006.41506141
0,31,5,2,2,2,11,1610764.08918851,5388167.67574054
1,40,2,3,1,3,9,1352588.28112193,8193872.60091171
0,19,5,3,0,2,10,1646947.56762763,4456233.22005136
1,40,1,3,0,3,7,1647682.03608602,4470962.91425471
0,11,3,1,0,2,6,1500599.00009824,3679913.09722064
1,33,4,1,1,6,12,2455688.69704394,4530281.67310057
0,18,3,2,1,7,13,2233099.58829369,7075679.3831258
0,25,5,0,1,1,7,1829427.15012278,3552399.36334782
1,37,2,1,1,4,8,1328068.56718567,6799113.27043643
1,35,0,0,0,6,6,2018422.4308153,7143634.0499567
0,39,6,0,2,1,9,1878638.98065293,7628650.64008811
0,26,2,3,2,2,9,2202136.98314101,6607386.11170406
0,30,1,3,1,0,5,1694149.02904134,5278632.92451442
0,11,6,3,2,1,12,2155824.51745628,5671998.60711282
1,22,6,3,2,0,11,2311489.57899862,7038791.76907625
0,10,4,3,2,1,10,2306139.29995353,5632309.22710119
0,28,6,2,0,2,10,2195196.09380218,7845537.78931235
0,33,0,2,1,3,6,1900101.36797501,4125331.21342808
0,24,6,2,2,5,15,2201646.6716477,1454553.86738841
0,38,6,0,0,3,9,1997822.59378193,6274911.2676191
0,37,3,2,0,7,12,2174855.04907426,8189161.24427292
0,31,5,1,2,4,12,2367588.44840569,7342410.96163
0,24,4,3,0,7,14,1360725.91881049,7387662.61831713
0,17,4,1,0,2,7,1533397.726385,2594456.34642582
0,29,2,1,1,4,8,1552930.21603844,8526519.2392568
0,39,0,2,2,0,4,1627101.21870408,4632238.97672559
0,18,5,2,2,6,15,2649636.19823856,6577932.43266507
0,30,2,0,1,0,3,1262303.67301749,1106373.79830551
0,36,1,0,2,0,3,1409030.4039562,3880437.42231834
0,39,4,1,0,7,12,1853492.62677867,6148263.75955342
0,18,0,0,2,3,5,1837104.33819318,6095302.70114877
1,32,4,2,1,5,12,2245662.71487296,8210101.75671491
0,26,5,0,1,3,9,1670452.45556478,2621636.87670345
0,32,2,3,0,7,12,2561976.35148699,8778038.19656246
0,11,2,2,2,7,13,2641033.52060885,7672561.94309764
0,17,3,1,2,4,10,2416280.25594961,6270498.70428853
1,38,0,1,0,5,6,1685353.61674244,5319557.15359403
0,32,0,1,2,6,9,1831786.94301719,4134056.01764026
0,18,6,2,2,1,11,2306567.5217278,7167620.88668621
0,11,0,0,0,6,6,1864745.99462927,6108866.68720169
0,28,5,3,0,1,9,1961505.23003406,3667011.78394874
0,35,4,0,2,3,9,1907144.32261075,8590819.35954977
0,20,1,2,1,0,4,1076214.17545774,2815765.21315535
0,34,5,0,0,7,12,1224513.80758514,7011042.88573942
1,19,1,3,0,5,9,1823187.59744426,2925321.00813257
0,14,1,3,0,7,11,2354524.82712782,3295733.42384693
0,19,1,0,0,1,2,825147.968011223,4398700.34256885
1,28,1,3,2,5,11,1815964.75229576,9448682.96449408
0,39,5,1,0,6,12,2178202.91607159,3902259.69957941
0,11,0,0,1,4,5,1459065.84497794,3916378.51106755
1,19,0,0,2,4,6,1537617.12797687,5631831.00390661
0,40,0,0,0,5,5,1555790.28411714,3969600.58307127
0,37,6,1,0,1,8,1543994.36534442,2372248.20201654
0,31,3,1,0,3,7,1551034.66968997,6311596.7969266
1,18,4,0,1,1,6,2110308.08825651,4499132.76377436
0,27,3,1,0,0,4,1393126.70004792,3637659.06970669
1,27,3,1,2,0,6,1698996.26130624,3529022.34677144
0,22,6,1,2,6,15,2474817.77441929,9218155.86763647
0,23,1,3,2,3,9,1984155.47445255,5067791.98644419
0,22,4,3,1,2,10,1826589.15382683,6529174.72886248
1,33,6,0,0,1,7,1716131.53822195,6992671.88866314
0,15,0,2,2,4,8,1998179.07159792,5472483.81254927
0,11,4,1,2,1,8,1892419.53396862,6888546.77781371
1,21,6,3,0,5,14,2978730.02741078,8329046.06840604
0,15,5,2,0,1,8,2224529.86113517,6075674.66849565
0,18,4,1,2,7,14,2973300.06496209,5195049.03786099
0,22,6,3,1,5,15,2433914.39173155,4979746.85917437
1,17,1,2,2,0,5,1553446.00327426,4623449.23514399
0,32,3,0,2,6,11,1819074.88455208,5962516.27548898
1,23,5,2,0,0,7,1431786.05504732,5133568.46315633
0,36,4,0,2,1,7,1679795.23092762,6381117.6320544
0,26,6,2,2,6,16,3048290.35182291,10049699.123189
1,11,1,2,2,2,7,1938972.96182096,2852439.36073612
0,10,2,1,2,7,12,2647222.73099144,6103758.45168529
0,12,2,1,1,3,7,1520717.33005834,4939696.54761513
0,40,1,2,2,3,8,1568276.17575751,3697568.00554894
0,33,1,3,0,4,8,2046194.1764911,5588967.09453222
0,31,6,3,0,0,9,1742981.8314874,7059379.54684566
0,25,2,3,0,3,8,1224096.57232408,6721300.91161287
0,33,2,0,0,0,2,1196546.73923998,5167553.0933182
1,18,1,2,0,5,8,1522321.19451748,7226515.36155062
1,39,3,2,2,3,10,2328768.43880298,3440668.18742203
0,36,2,0,1,7,10,2141496.06321026,5644728.31089192
1,23,1,0,1,7,9,1634535.56757581,5958676.75696377
0,40,6,1,1,2,10,1859707.48041344,5840442.84516116
0,21,3,1,1,0,5,1513176.34197266,5399874.18627262
1,12,4,1,2,1,8,1638740.21315508,7703992.13818101
0,13,1,2,1,6,10,1718459.64111164,10044202.152986
0,32,3,0,1,3,7,1687598.81653755,5978880.44752208
0,32,6,2,1,0,9,1977743.20028604,2041894.06782789
0,17,6,0,1,1,8,1921984.89710973,5134946.24961093
0,31,0,1,0,7,8,1598960.37920845,818569.622625561
1,30,2,1,0,3,6,1697197.43671951,3189921.99988901
0,38,2,0,0,7,9,1522231.20587532,7239996.96117318
0,25,4,1,2,0,7,1646644.61268625,6423215.00744953
0,13,4,3,0,7,14,2328999.81218879,3112947.30353104
0,39,6,3,0,5,14,2591772.04393928,5859116.86397284
0,10,2,2,1,5,10,1859371.80034575,3586205.14387872
1,32,1,1,1,1,4,1641959.468894,6148975.33810193
0,21,0,0,1,2,3,1378714.52601425,4476150.66546461
0,40,3,0,0,7,10,2311138.41288972,4094499.9745981
0,11,1,3,1,3,8,1966502.0586351,4111219.08649074
1,38,1,0,1,4,6,1432312.71282477,2301138.37487341
1,34,0,2,2,0,4,1272803.13806618,4428796.36953085
0,21,3,1,0,3,7,1529392.08327937,6911350.26742524
0,40,3,0,2,5,10,2075376.97038073,3482182.82933656
0,31,4,3,0,6,13,2083571.28548959,6690679.65145913
0,16,0,0,2,2,4,1538407.66060338,3309037.74138211
0,22,1,2,0,6,9,1644525.68428124,7168542.92237562
1,11,0,2,0,1,3,1192115.48770989,4160116.68678699
1,26,0,2,0,7,9,1867812.52147445,5195486.73979137
1,30,3,0,0,4,7,1791142.80376317,7036872.89520028
0,40,0,1,1,0,2,953736.51010712,3065075.86426877
0,21,0,3,0,2,5,1725600.84056207,1383586.6708812
1,23,6,2,0,7,15,2191634.8536641,10277005.0267377
0,24,1,3,1,0,5,1582951.19249737,4862182.83084433
0,32,1,1,2,3,7,1456519.48572701,6807000.52233361
0,34,3,3,2,7,15,2273709.27689449,8069755.96021806
0,25,2,3,0,2,7,1813723.89621949,4728451.01534751
0,22,5,1,1,5,12,2263420.72726412,4498565.0986253
0,38,2,2,0,5,9,1837629.03768278,3716080.4184021
0,13,1,1,0,6,8,1567571.17165343,4466298.72922608
0,21,4,2,0,0,6,1799134.9138763,2642722.01708919
0,13,6,1,0,6,13,3355554.14428144,8061860.24862611
0,31,5,3,1,2,11,1664193.17075238,8951371.33320867
1,39,4,1,2,7,14,2314041.1846419,8476408.71067931
1,27,6,2,0,0,8,1872489.19140242,7345404.09943957
0,15,2,1,1,0,4,1073608.90618992,3534015.63550986
0,32,1,3,0,5,9,1757487.8209867,5979393.26304601
0,31,6,1,2,1,10,2790049.52919157,2114097.3465811
0,23,1,2,0,3,6,1536159.06266949,2472252.32306525
0,15,5,0,0,6,11,2134016.13046476,3660526.50397328
0,17,5,3,1,5,14,2451278.40109223,4014490.92659677
0,34,4,0,0,4,8,1715551.88895503,4500530.12701699
1,19,0,1,2,2,5,1436768.29982563,2913811.42661993
0,38,6,2,2,3,13,1872487.77519351,4941168.37505246
0,36,0,2,1,7,10,2005923.08171074,5686048.49766422
0,11,3,0,0,1,4,1435747.10153416,3723089.86268775
1,22,0,1,2,4,7,1776358.78588815,5215988.89245474
0,10,3,2,0,6,11,2310872.10345952,7160912.27660719
0,19,1,3,2,6,12,2337965.75015404,7933536.91797014
0,40,2,2,1,5,10,2254235.38386883,5226663.08631235
0,29,1,3,2,3,9,1948224.64708827,6624967.06071422
1,35,5,2,2,3,12,3085015.51296606,3110029.16187877
0,19,5,2,0,0,7,1697501.11440067,3837290.48594383
1,33,3,3,0,1,7,1444582.77377646,5382426.82696989
0,10,6,0,1,3,10,1704984.14245708,8438335.00935867
1,35,6,2,0,0,8,1774023.54691364,3557548.65132378
0,31,6,2,1,0,9,1463159.04321255,6797486.14902238
0,30,0,2,2,3,7,1517470.34475664,6193021.62211187
1,29,0,2,0,2,4,1347628.33590879,5930625.09339695
0,14,0,3,2,3,8,1823423.51788897,4861101.53618458
1,16,3,0,2,3,8,1699150.26152715,3462742.94144114
0,21,3,1,0,1,5,1579337.08096418,3434459.03021885
1,14,5,2,1,4,12,2358527.85959859,6372760.80027204
0,13,4,3,0,6,13,2953350.69966879,4201492.88221612
0,29,1,1,1,7,10,1228350.72674046,5998147.4138953
1,39,4,3,2,3,12,1812647.5460812,5498401.08188069
1,29,5,3,1,6,15,1710573.97765069,5155061.91274087
0,11,1,2,2,1,6,1759535.39891264,5455943.88270826
1,28,3,1,0,4,8,1734715.46248882,4695073.50711768
0,24,0,2,2,4,8,1865257.3571646,7642573.66414026
0,11,6,1,0,2,9,1777538.07702941,7379941.52376817
0,14,5,3,1,7,16,2713908.65744158,5314252.45361073
0,23,6,2,2,3,13,2060981.50376095,8060405.47657248
0,33,1,1,0,3,5,1784244.37072855,1315992.30670008
0,13,2,3,0,1,6,1710023.87697752,6248196.45257826
0,30,2,0,2,1,5,1759659.56391663,6420063.17162262
0,36,1,0,0,7,8,1375492.94816573,4260741.94674209
0,11,0,1,0,5,6,1377911.56649384,3465325.16922005
0,11,0,1,1,1,3,1421218.61985358,4510764.61565331
0,16,1,2,0,1,4,1393371.13532454,7609912.40443105
0,40,6,0,0,7,13,3084468.5929882,6221529.31801648
0,39,0,2,0,6,8,1758514.30031576,5927570.45681252
0,37,3,0,2,0,5,1336578.50710416,2949907.37747611
1,24,4,2,1,7,14,2381503.76389556,5649650.48395422
0,11,2,2,0,3,7,1820383.40873204,5945863.89870929
0,18,4,2,0,0,6,1028906.451289,4131362.53221661
1,16,1,3,2,3,9,1079773.45027294,8905191.70495705
0,16,0,3,0,2,5,1999230.70728812,3639335.53592615
0,23,4,3,1,2,10,1831158.78772148,5582687.39378222
0,35,2,3,1,1,7,1708892.01351042,5028313.35550531
0,23,3,0,0,6,9,2061135.82296157,5442728.47784997
0,28,6,0,0,7,13,2558122.26697817,6031920.82616562
1,18,2,1,0,5,8,1755620.24553773,9144751.42447101
0,37,2,2,2,0,6,1557814.91402668,3788414.6358907
0,31,6,1,0,3,10,2214083.2710223,6708668.38807132
1,24,4,2,0,1,7,1628243.88213816,6403201.411299
1,37,1,1,0,2,4,1177749.92438335,3266149.95142313
1,24,4,0,2,0,6,1756056.17080576,4564423.52669865
1,37,2,3,0,2,7,1603219.28564294,7060112.27142046
0,11,6,2,0,7,15,3244192.6726363,9535789.56096162
0,27,2,3,0,4,9,1686233.25069894,5734809.28302444
0,23,4,1,1,6,12,2594770.13267064,4615691.68710542
0,22,4,2,2,3,11,1711689.49158807,3892152.43205319
0,20,5,3,1,6,15,2333250.93334827,8426345.25210039
0,22,4,3,0,5,12,2240333.40360254,1906133.53010994
1,20,5,0,0,6,11,1929858.60689684,7830156.85744215
0,13,3,0,1,0,4,1417511.62779967,4789326.41517218
0,28,0,0,0,6,6,1563478.29847084,7065764.03066599
0,17,4,2,2,4,12,2169720.93746508,4918432.7853119
0,25,4,1,0,1,6,1168388.90518931,5657827.74783129
1,38,4,3,1,6,14,3179392.56276691,6988370.56630514
0,35,5,3,0,6,14,2857298.33098984,10248148.4979069
0,17,4,2,0,1,7,1711662.24059276,5386363.44094988
1,39,6,3,0,5,14,2409242.37665515,8863349.90177442
1,12,2,0,0,2,4,1292831.24270413,2461934.35706694
1,17,1,3,2,1,7,1856108.90079338,3839399.38195803
0,15,5,0,2,3,10,2109357.93506691,7542341.63264002
0,14,0,0,0,3,3,1439779.788443,4042612.71344089
0,10,5,1,2,5,13,1678605.81092379,7424586.20358311
1,39,5,3,2,0,10,1735041.14587347,2245934.839088
0,32,2,1,2,5,10,1653138.82834265,9274573.12568117
0,33,6,0,0,6,12,2343222.33880532,7831738.68054694
0,16,4,2,1,7,14,2171989.12684934,9102393.85276819
0,34,0,3,0,7,10,1937747.12791976,7152515.92068941
0,28,2,0,2,3,7,1812761.25399247,4577314.29277326
0,10,2,2,1,7,12,1870540.72154401,6944426.53495366
0,19,2,0,0,5,7,2098725.32010113,4244202.74980321
0,23,5,3,1,4,13,2153011.14841349,6923411.57199868
0,34,5,2,1,7,15,1938052.63941377,9818305.82995594
0,18,5,3,0,2,10,2095002.01484164,8030470.08676809
0,18,5,1,0,4,10,2264046.7023807,6375613.13067005
0,18,0,2,2,0,4,1128947.13265624,5352125.85988249
0,19,3,1,0,1,5,1646249.99866466,4496620.70549133
0,11,3,1,2,0,6,1428933.80496501,4644169.97715874
0,33,4,2,0,6,12,2315911.03558264,5807139.5306396
0,14,5,3,1,6,15,2423332.40773305,3444797.57770073
0,28,1,2,2,3,8,2103589.53109851,6741607.55775414
0,25,2,1,2,4,9,1938730.38947026,4977378.44731733
0,28,6,0,1,7,14,2050321.85055725,9054125.79744096
1,35,0,3,1,3,7,1959696.65703272,5349210.37834028
0,11,5,3,2,7,17,3225258.03195283,10246331.2743218
0,34,3,3,0,4,10,1253047.56986002,5569128.25186808
0,37,2,1,1,7,11,1952854.62239131,4576445.52380407
1,33,4,0,1,0,5,1194695.93927543,2987446.06554782
0,40,5,1,1,2,9,1943899.16815523,6023898.67636167
0,23,3,1,0,5,9,1898757.11344281,9106111.26250314
0,11,6,3,2,4,15,2470102.28167221,4507436.26707423
1,16,1,1,0,2,4,1413220.04229689,2101113.94201198
1,24,2,3,1,4,10,2286770.80183187,7717969.81355345
0,24,1,3,0,1,5,1025304.22589851,2653941.99829924
0,27,0,2,2,2,6,1504334.52943795,4407571.36860476
0,37,1,1,0,5,7,1759091.38843724,180049.782406546
0,11,4,0,2,7,13,3024423.78690651,5829762.06620403
0,33,3,3,0,2,8,1925882.12291794,5241271.88062959
0,18,1,3,1,4,9,1921616.96317192,4094690.54752748
0,30,6,0,1,2,9,1304226.32532274,6614615.87390764
0,21,0,1,0,5,6,1440032.51279896,3901161.42270834
0,37,2,3,0,1,6,1758213.05934309,4860789.1521198
0,19,0,3,2,3,8,2025722.69705728,6343006.66862445
0,27,1,0,1,0,2,1443727.75892261,4778135.85106372
0,20,3,1,2,7,13,2460106.64922667,8716636.15755791
0,10,0,2,2,7,11,1621403.27847694,7817319.37363489
0,18,6,3,1,5,15,2729405.38170337,5067676.72343373
1,26,4,2,2,6,14,3034550.63182825,5601662.38979104
0,25,6,3,1,5,15,3417782.25528826,8598562.0945394
1,37,6,1,2,2,11,2413370.82047593,5855869.8226923
1,27,3,2,0,6,11,1920721.59686885,5350796.49739262
0,12,3,3,2,6,14,2024966.88645362,9692240.00028787
1,14,1,0,0,7,8,1900563.81977129,5714189.76698078
0,20,2,1,2,1,6,1831415.3445328,4109377.50502062
0,33,4,2,2,7,15,2674803.34098951,8023582.16064355
0,33,3,1,0,4,8,1809348.98270194,7010338.36709527
1,35,3,2,0,2,7,2213225.66186577,4362596.53970079
0,34,5,1,1,1,8,1705737.13187554,5098407.21651065
0,36,3,2,1,5,11,1656685.52088523,4554874.72118719
0,24,0,2,2,5,9,1372908.36320566,6006547.70723284
0,14,4,3,0,1,8,1781275.63440944,5338998.79090321
1,16,4,3,0,2,9,2115526.16016751,4114676.04729253
1,19,1,3,1,6,11,2297575.541713,5118334.49049007
0,29,3,0,0,1,4,1305410.9201523,2541422.48815183
0,24,3,2,2,7,14,2578246.36859867,6709763.71798255
1,36,6,2,2,4,14,2371092.68269138,11187644.6137697
0,32,5,2,0,7,14,2501571.64187019,8493966.2965741
0,34,4,0,1,0,5,1508570.30125114,7527391.53842409
0,13,3,3,0,3,9,1819498.3330203,2181151.43402792
0,35,0,2,0,3,5,1401052.98208911,5248966.05887554
0,37,1,2,0,0,3,1207380.14036617,4058731.20109504
1,15,6,0,0,1,7,1662394.89277826,10715580.9914356
0,11,0,2,0,5,7,1811326.44863987,2425770.93337734
0,14,6,1,0,7,14,2958161.40285941,6967171.60208376
0,30,6,3,2,5,16,2004197.89323884,6533915.07022536
0,39,5,2,1,3,11,2472872.67012764,8581952.52689341
0,11,6,0,2,2,10,1369093.91817631,5784037.63490911
1,28,1,3,1,4,9,1803572.67384582,7013508.791888
0,17,4,2,2,6,14,1980590.90924262,5899821.16978672
0,31,4,1,0,5,10,2147434.27050173,5734530.98904397
0,22,6,2,0,5,13,2853948.38768505,4105951.03512653
0,33,3,3,2,7,15,2622516.24797568,10155635.1711765
0,15,1,3,1,2,7,1748450.57962979,4747531.01940621
0,38,5,0,1,5,11,2187571.56128063,6413116.21207871
1,24,4,0,1,0,5,1016935.10938506,5552496.39015217
0,22,5,1,2,5,13,2093506.40739305,8977598.71570647
0,35,1,0,0,7,8,1977798.52113186,5121345.54890553
0,28,5,2,2,7,16,3130022.33303083,10494608.316539
0,31,6,1,1,2,10,1712709.84913729,7649107.61181668
0,21,1,3,0,1,5,1320290.7217342,3548687.50450274
0,40,2,1,2,7,12,2407928.25747982,7293105.82524139
1,35,6,2,0,0,8,1888383.11740074,2721352.8008095
0,27,6,0,1,1,8,1605232.58816081,4061404.29712169
1,40,5,2,2,2,11,2120354.72770968,6069206.2447844
0,10,0,2,0,3,5,1836676.84929904,3620658.32988347
0,12,1,1,0,0,2,1252628.76498527,2709024.95978652
0,35,0,2,1,0,3,1219204.34014838,5136332.18911892
0,12,2,0,2,4,8,1863859.63924328,4651349.08490005
0,29,0,0,0,7,7,1556242.31453936,4660251.57078564
1,24,4,1,0,5,10,2146519.37177835,5776591.63563702
0,35,5,0,2,6,13,2689724.09854037,8491759.28402181
1,35,3,3,0,0,6,1670942.84811985,2077267.37907205
0,25,1,1,1,0,3,1037138.68756513,2429263.43505378
0,29,5,2,1,1,9,2214377.40276147,5041440.46527935
0,34,3,2,0,5,10,1862240.35748987,7800155.06279676
0,20,5,2,1,7,15,3249836.78195743,9293497.25147755
0,13,0,3,0,2,5,1316440.89806871,2999206.24266356
1,18,3,0,0,1,4,1928320.71882865,4075093.36199812
0,33,4,1,1,1,7,1922180.48135139,6076864.12368412
1,40,5,2,1,5,13,2232618.13152327,6592709.50956021
0,30,0,1,2,4,7,1836477.09804975,4610448.58370787
0,26,0,1,0,3,4,1388219.55281361,6717652.12180435
0,35,5,0,1,6,12,3042825.07363151,6891351.72941654
1,40,6,3,1,4,14,2701785.16301431,6210801.55369371
0,31,3,1,0,6,10,1769533.23884415,7948418.43962382
0,12,0,3,1,6,10,2132459.68955625,7420934.72832746
0,32,0,0,1,1,2,1491094.9201812,5646883.7520181
1,26,5,1,1,5,12,1425070.91002583,8998433.47746803
0,18,3,1,0,3,7,2004988.8920281,6737934.92204976
0,26,4,1,2,0,7,1872618.40048571,4099114.44363514
0,35,1,0,0,3,4,1252953.97100979,5513264.13949558
0,33,0,3,0,7,10,1795291.08160947,9749501.80133775
1,19,6,0,2,3,11,2355319.5322861,5586164.8371501
1,25,6,2,2,1,11,1740880.54564155,6370580.49963396
0,22,4,1,0,5,10,2035492.71841671,5439668.90539793
1,18,3,0,1,4,8,1689135.1722641,2009640.33592959
1,16,3,1,2,0,6,1472985.23618512,5338829.33988037
0,38,2,1,0,2,5,1740089.37264746,3386063.25598941
0,17,4,0,1,2,7,1869292.63921881,5382747.06281339
0,37,0,0,2,7,9,2248660.96266875,3979529.27879885
0,37,5,3,2,5,15,2929407.0235538,8186702.64655569
1,24,5,0,2,3,10,1825724.08517038,8398244.24788732
0,35,1,1,2,0,4,1368390.21893933,6217677.29283734
0,24,0,2,2,1,5,1244420.26049632,3554217.37429353
0,22,0,0,2,6,8,1660541.94529836,4079370.32172804
1,36,2,2,1,5,10,2026179.01044675,6834054.58809977
0,28,1,0,2,3,6,1824543.65723533,6376010.44372213
0,30,1,2,2,4,9,1724893.48245876,6915139.55034262
1,24,5,2,0,2,9,2371992.37381994,2371992.37381994
0,36,3,2,2,4,11,2796126.13101084,6528112.46277278
0,27,5,2,2,6,15,1802343.10536904,5692611.46372622
1,32,0,3,0,5,8,2010044.96595197,7956579.33766773
0,39,0,1,2,1,4,912864.290339362,1617328.08611198
0,22,1,2,1,1,5,1480899.39826899,3504182.25687599
0,17,5,0,1,0,6,1757071.53672212,6088897.77480724
0,34,5,1,2,2,10,1738099.59987714,6255994.46300823
1,35,4,2,1,5,12,2097980.58374371,8738290.88992899
0,24,6,3,1,6,16,3217279.54230236,9958409.12904455
0,32,6,3,1,4,14,3138493.30487118,6313260.53162743
1,11,1,2,0,6,9,1901249.00513931,6113488.68723405
1,31,1,3,0,3,7,1481176.14275724,725011.957686562
1,13,0,2,0,7,9,2679818.75216424,9550052.53138258
1,25,5,1,1,7,14,2714995.12673455,6721112.26244054
0,29,5,2,1,2,10,1928449.44882214,4647652.00655065
0,22,6,1,1,6,14,2105092.25958026,5122690.10424486
0,36,0,3,0,4,7,1930513.95420036,5823522.75258705
1,39,6,0,0,0,6,1510452.30504886,2725806.99938303
0,29,2,0,2,6,10,2110193.70562327,6216501.96706478
1,26,3,2,2,3,10,1930384.89265707,5956442.23263279
0,21,5,2,0,4,11,1913377.24353009,6424333.75702732
0,40,0,0,1,2,3,1530666.61432547,3918564.280292
0,31,3,1,2,3,9,1747475.62057063,4924498.68017078
1,21,4,0,2,7,13,2894372.93866609,6536896.70075721
0,35,3,0,1,7,11,1719702.75899166,4465059.09156403
0,27,0,2,1,0,3,1104748.28732016,4303324.8698629
0,37,1,3,2,7,13,2248435.11324133,3127259.55185989
0,20,0,2,2,3,7,1513152.82882993,5470141.81062282
1,17,6,3,1,3,13,2499388.46899796,5374770.32557506
1,29,6,1,1,2,10,2237765.58455952,8555855.51441557
0,16,0,3,2,6,11,1326827.1400514,6674210.81987031
0,22,6,2,1,1,10,2073740.99863396,7671486.48953824
0,24,5,3,1,6,15,2517948.91965503,5182345.63991809
0,31,4,0,2,7,13,2092356.75260122,7910384.39468768
1,35,5,1,2,1,9,1892278.13019079,4613565.14496859
0,12,2,1,0,4,7,1402752.34630446,6630101.36167585
1,26,2,3,0,1,6,1918766.00474254,2974104.21681485
0,21,4,2,1,0,7,1902090.39279184,4622208.14101618
0,11,0,1,0,3,4,1799166.31250596,3138077.16027771
0,15,5,3,1,0,9,1947043.90952405,4146244.61717846
1,14,1,0,2,6,9,1530602.02190605,6154890.2938271
0,22,0,1,0,6,7,1553018.73611877,5431002.83858265
0,36,2,2,0,0,4,1011993.12948716,4339901.48358353
0,11,1,1,1,4,7,1793833.8924178,3855058.89581683
1,40,5,0,1,0,6,2073422.34009068,4490375.87801047
0,30,3,2,1,5,11,1827314.85173867,5757807.37311067
0,11,4,0,2,4,10,2141551.58225046,7350284.82229936
1,37,1,1,2,0,4,1789368.85306716,5421679.23761265
0,28,4,1,2,3,10,1704622.9353318,3420612.25090003
0,17,2,2,0,2,6,1734576.22649901,6547154.57674194
0,20,0,3,0,1,4,1271295.66265186,4265921.37698168
0,16,5,1,1,6,13,2028171.15060321,4000702.43145233
0,40,4,2,0,7,13,2562518.31358814,6289610.73710586
0,25,4,2,1,3,10,1783869.16414792,1635476.6017236
0,25,0,3,0,0,3,1241170.43932604,4722295.12418552
0,31,5,3,1,4,13,2097404.45994184,5124495.25784434
0,17,0,3,0,5,8,1532177.37625412,5764067.38722525
0,21,3,1,1,6,11,1311940.37719484,4262339.70163347
0,39,5,1,1,1,8,1956221.325604,4915655.57349099
0,24,3,3,2,4,12,2318027.08431924,5427427.81890478
0,20,2,0,0,1,3,1057891.16792639,5436448.97038478
0,36,2,0,1,6,9,1230968.73140037,4030450.56088041
0,19,2,3,2,6,13,1807271.99780362,6061215.06161507
1,17,6,1,0,2,9,1722940.72593716,10051131.8501528
1,14,5,3,0,6,14,2492637.11112227,6120818.04340392
0,16,1,3,0,5,9,2068605.31493744,4080340.81887505
0,26,3,1,0,5,9,2113714.05362732,8799585.40567814
0,14,5,2,1,3,11,1950710.48662016,4423153.01199385
0,30,1,0,0,7,8,2098553.40197927,7128278.87617954
0,24,5,3,2,2,12,2126362.2323124,7204940.02453994
1,31,2,0,0,4,6,1477731.76932661,1404169.59696564
0,17,5,3,0,6,14,2109950.04082499,9162448.18670062
1,15,0,3,2,3,8,1984699.39590955,6922610.61780492
0,25,4,0,0,6,10,1923895.78706213,8356691.93443355
0,33,1,3,1,4,9,2001025.21335147,5110873.22857533
0,40,1,3,0,0,4,1317706.98668791,6397669.06597169
0,34,4,3,2,3,12,2148233.49060585,11715997.3153295
1,25,4,2,2,4,12,1750977.61741235,6542219.001668
0,23,6,0,1,7,14,2435861.32663324,9190288.6035852
0,37,5,2,2,4,13,2114256.36141029,5634944.6290598
0,37,0,1,2,3,6,1958167.54693291,3061492.16672884
0,27,5,3,0,6,14,2499515.47776685,7700122.67655282
1,16,2,0,2,7,11,2869164.12237146,7662774.21379511
0,23,6,0,2,2,10,2021572.45541997,4769371.17701766
0,38,2,2,2,3,9,1801462.82859503,7792081.94642666
0,17,2,1,0,5,8,1354073.05643756,6554772.68799406
0,36,1,1,0,4,6,1515924.93081033,3970843.05658612
1,40,5,1,2,7,15,2438950.85415011,6614060.36954238
0,23,0,0,0,5,5,1403910.72938312,3900328.24324698
0,26,0,2,2,0,4,1419858.31836483,4375535.72426917
0,36,3,1,2,0,6,1861823.71292013,6060973.79813389
1,29,2,2,0,6,10,1926000.37623388,5327663.45535746
1,22,1,1,1,0,3,1645838.29442336,6184798.84241466
1,27,6,0,2,3,11,1955033.61062992,6115150.0951714
0,33,2,2,1,2,7,1691597.5783926,5593964.28889512
0,29,0,3,2,7,12,2557081.45523125,6673779.13593466
1,35,3,1,2,5,11,1562899.21168836,7702637.14241522
1,23,6,1,1,3,11,1797615.59558981,5692654.37279623
1,15,4,0,2,0,6,1651271.59367797,4430312.81419042
1,26,6,2,0,5,13,1561899.46655104,8553743.33325193
0,36,4,3,2,4,13,2365153.46593208,5461279.52902852
1,26,3,1,2,7,13,2125279.63542857,6860049.39567353
0,10,3,0,1,1,5,1306753.01709221,2198550.87517893
0,12,1,3,2,1,7,1312390.73682982,6106775.62535585
0,16,1,0,0,0,1,1076886.19703502,228568.878485605
0,17,0,3,2,0,5,1644762.99289624,5996231.23268809
0,32,6,1,0,6,13,2124707.05395641,1850800.22145897
1,39,4,2,1,2,9,2294011.10770314,2195667.41976172
0,27,6,3,0,5,14,1839861.55864737,7968759.6380768
1,12,6,3,0,4,13,2158955.52525466,5440596.21111034
0,21,4,0,2,5,11,2006067.03851253,6958358.82951538
0,35,3,0,0,4,7,1578839.42615008,5907426.07271113
0,31,4,3,2,6,15,1976238.08886716,9383143.59035788
0,19,3,0,2,4,9,1400004.86031328,6758474.97270682
1,12,0,3,0,7,10,1064550.20511967,6054155.61686062
1,29,2,0,2,4,8,1784465.11556416,4094553.61338861
0,37,2,0,0,6,8,1949806.30162712,5189713.83260195
1,19,4,0,0,0,4,1595310.30018159,5924051.60920234
1,10,6,2,2,2,12,1797954.44279792,5260019.70417294
0,13,1,1,0,5,7,1778247.45284878,5937528.61363609
1,12,6,2,0,5,13,2606738.42579793,6581592.92553954
0,21,5,1,2,7,15,2019513.42351285,4063150.45791021
0,12,1,2,0,5,8,1822341.79475333,5537967.00009892
0,19,4,1,2,3,10,1806941.21328459,5981201.81260984
0,10,0,1,2,3,6,2138425.67725125,3347190.51650031
0,20,3,3,0,3,9,1923883.0248219,5861442.85457146
1,11,6,0,2,7,15,2526665.85785206,4757431.58600561
1,11,4,0,2,5,11,1549815.37851388,6407347.73086616
1,34,4,2,1,0,7,2033667.72243134,8030576.97958815
0,30,6,0,1,3,10,1142143.70379287,8242235.87852832
0,22,6,1,2,0,9,1837807.50586905,4189098.65944339
0,22,1,3,2,1,7,1744584.2661831,4205507.08382521
0,36,0,2,1,3,6,1535582.64294926,3959735.87942271
0,23,4,0,1,1,6,1234948.14962728,3977923.60538955
1,28,1,1,1,3,6,1244559.63610206,6389974.14597015
0,16,4,2,0,1,7,1795305.09385487,4055959.59753206
0,13,3,0,1,3,7,1742829.11892157,5227428.30203179
0,26,0,0,1,5,6,1738713.92591023,5349377.31381995
0,11,4,2,0,3,9,1710674.97611073,4781914.6476187
1,16,4,1,2,7,14,2914458.76371537,6993337.80403724
0,35,4,3,0,3,10,2157688.3607127,4059119.37278723
0,28,5,0,0,0,5,1481563.53220449,3287259.1679337
1,25,5,2,0,3,10,1436889.72044974,6357834.31436449
0,29,1,1,2,5,9,2278246.85171787,7170964.14217337
0,15,1,3,0,0,4,1650918.00421298,5267555.23184793
0,27,0,3,2,5,10,1993652.06865258,9123538.8505666
0,40,3,0,1,5,9,1438180.55261118,5289711.71147335
1,15,2,0,0,6,8,1871413.12883384,5995472.34390682
1,11,6,1,0,2,9,2352340.08022923,2165473.86128588
0,29,6,0,0,6,12,2109978.86902598,6704809.91348665
0,14,4,3,1,6,14,3029018.69931399,2802722.12768793
0,23,5,2,2,0,9,2145616.2588786,8529359.21907339
0,16,5,1,2,7,15,2209625.7865917,12071015.4065005
0,37,6,1,2,3,12,2273322.60350492,3149061.0133408
1,34,6,1,1,3,11,1837246.19796356,8755062.87159412
1,28,5,1,1,4,11,2226384.07671713,5983902.47069934
0,14,3,2,0,2,7,2061183.65589871,497647.701947385
1,34,6,0,1,1,8,1924187.9873403,4275896.46822459
0,33,2,1,0,3,6,2007324.77675281,5544896.72584903
0,10,6,3,0,4,13,2472497.43004335,8161149.6417931
0,33,1,2,1,7,11,1733975.19183247,2592876.32522284
0,26,2,2,0,5,9,1769118.68179234,7131407.69619572
0,10,3,0,0,5,8,1517924.6914749,8112622.15178411
1,18,2,0,0,4,6,2384924.78673704,3239451.41421382
0,30,3,2,1,7,13,2381815.63911872,8589632.44089
0,40,0,0,1,3,4,1466027.66683706,2204295.65427798
0,25,5,0,0,7,12,2726870.62469248,6561427.45541272
1,27,6,0,1,6,13,2897666.3101463,5218610.28472261
1,39,4,3,1,1,9,1733674.14760754,6868005.03369516
0,21,0,3,0,3,6,1448896.70139763,5706326.69074378
0,35,4,1,1,6,12,1617149.19498961,7722352.08814708
1,23,3,2,2,3,10,2584357.90370932,2602578.16351559
0,37,2,2,1,1,6,1811027.94435852,3521557.38913581
1,10,0,2,0,3,5,1840013.58107234,4911925.83486942
0,27,0,3,0,0,3,1118121.47917921,3839574.8919078
0,28,6,2,2,4,14,2951320.68919217,8516336.36814419
1,35,4,3,2,2,11,2199009.06105267,8747037.97701787
1,23,3,1,0,3,7,1710132.72054874,4321588.15704702
0,19,5,3,0,7,15,3041987.24361651,5061622.0274433
1,21,4,1,2,3,10,2011633.007201,8625493.66242067
1,38,1,0,2,5,8,1883057.59525035,5427356.77102066
0,36,1,2,1,1,5,1197058.70767269,4229290.36162616
1,23,1,3,1,1,6,1609723.76733035,8248957.3356213
1,37,0,1,0,5,6,1520401.78540358,4843636.52192236
0,23,3,3,0,4,10,2354979.75164908,7673248.51302086
0,24,5,1,0,4,10,2395314.72447599,4194068.71063626
1,26,5,3,0,2,10,2398940.06857815,4395591.85946738
1,37,0,2,0,0,2,1262046.07056787,393390.65618873
0,37,4,3,0,4,11,2572536.55345221,3941300.99354614
0,18,1,0,2,6,9,2278005.60329887,10336305.2552858
0,28,4,0,1,4,9,2069262.82486006,6701814.005847
0,26,4,3,0,1,8,2273101.15992118,3241658.66594448
1,27,5,3,1,3,12,1704877.07001402,7365854.62070709
0,32,6,1,0,3,10,2159332.61738654,10222373.1050845
1,12,6,3,0,1,10,1944432.80110059,5995872.50763028
1,18,1,1,1,5,8,1414032.00427046,5031063.29922317
0,12,0,1,0,0,1,1002094.12168143,4591487.80378655
1,14,3,3,1,3,10,1977816.95805422,5914389.10029466
1,12,2,1,2,2,7,1958247.74310954,5875907.17998657
0,10,3,0,0,3,6,1551376.4109777,3984505.92026628
0,25,4,0,2,1,7,1769402.55786711,1508757.05835477
1,17,3,1,2,1,7,1791677.52143683,5406414.66055408
0,19,1,3,1,0,5,1536373.88748086,6698290.71855472
0,37,2,0,0,4,6,2065805.18906821,1082117.00653526
0,15,0,2,1,7,10,1830368.47861697,7194037.67881086
0,12,0,3,1,4,8,1605083.67764981,6036414.32274835
0,19,6,3,1,6,16,2560490.4444068,6477555.40589907
0,23,4,0,0,5,9,1089487.18514535,3548434.67757265
0,33,5,1,1,3,10,1742362.10889645,8595723.56631434
1,27,2,1,0,0,3,832170.69885347,1911985.77194464
1,34,0,1,0,3,4,1209415.94898199,4525307.02775529
0,36,5,0,1,2,8,2135183.82648903,6100164.95246097
0,22,4,0,2,0,6,1338673.33482377,4363565.37775194
0,37,3,1,2,4,10,2392857.63204247,3304579.17309308
0,16,4,3,1,1,9,2087121.13312375,7091347.73828319
0,20,6,2,1,2,11,2132480.03474151,7994778.927241
0,11,1,1,0,4,6,1751564.97933944,4948735.08179322
1,36,4,1,0,2,7,1542605.74956057,9971306.61931637
1,30,5,1,1,5,12,2589336.05552999,7053498.42888095
0,37,4,0,0,4,8,1792047.50230539,7326410.80680201
0,35,3,0,1,7,11,1504016.82990937,6325933.60324264
0,34,2,2,1,3,8,1090848.43351139,7692519.60273465
0,13,2,1,2,1,6,1764705.81043153,5922977.58497593
0,14,3,2,0,6,11,2184184.89700739,4598629.37377368
0,12,5,2,2,4,13,2286229.84029019,7939710.80646177
0,19,5,2,2,1,10,2331608.72150402,6211613.05090861
1,14,5,0,0,2,7,1672585.10304803,3772311.84237491
0,27,4,1,2,3,10,2126133.3501427,3881066.79862567
0,40,0,2,2,0,4,1452429.48750871,4867381.5742598
0,40,4,0,0,6,10,2005389.06909299,7962388.04322928
1,31,4,0,0,2,6,1604578.9513823,6139922.65244386
0,23,3,2,2,6,13,2376502.66666618,6831551.03478926
1,27,6,3,1,2,12,2231347.05614118,6352720.97076106
1,15,1,2,2,0,5,1325781.90054268,5971112.32757276
0,13,6,1,0,0,7,1157449.78235316,1261921.26299772
0,14,4,0,0,1,5,1156673.34408909,2634037.74826013
0,22,3,3,1,7,14,2214954.94285161,6679411.568621
0,32,4,0,1,3,8,1828748.48750061,94597.3161923895
0,31,6,2,2,7,17,2324918.89853412,5494364.97162505
0,12,1,3,0,5,9,2061178.71736876,4346111.37110296
1,34,0,0,1,4,5,1631497.20671861,3805548.48524311
0,30,5,0,0,6,11,2056227.01235227,6404353.16978256
0,12,3,2,0,1,6,1464284.11104898,5262118.06660815
0,34,1,1,1,3,6,1470056.0421234,7748658.47412565
0,10,1,3,0,4,8,1439929.72545139,1968782.26726565
0,17,0,3,1,7,11,1759251.22865188,4802318.19460213
0,19,6,0,1,6,13,1762569.80747522,12672892.6019041
1,11,6,3,1,6,16,3096542.54772758,8052769.58280252
0,32,5,1,2,4,12,2132034.03703675,9565974.33912268
0,33,0,1,0,3,4,1625554.22023017,4585857.36211272
0,23,0,2,2,3,7,1673378.04400752,7081960.53568232
1,15,5,2,0,1,8,1465246.97747652,6156873.74562056
0,22,2,1,0,3,6,1486856.52661471,5185737.61795424
1,26,0,1,1,0,2,1508256.60369114,1414306.77887707
0,22,1,3,1,2,7,1603356.65592342,3649524.30995568
0,12,1,1,0,5,7,1684866.10436436,3536587.62531118
1,12,0,0,2,6,8,1662547.10715148,5141662.21624357
0,40,0,1,2,5,8,1355298.56724278,5098998.26000447
0,15,3,2,2,7,14,2686531.86478101,7835720.54139842
0,37,5,3,2,2,12,1991596.53244518,5300813.41101015
0,37,0,1,1,3,5,1545936.90880588,5186848.12916717
1,31,5,0,2,4,11,2201284.39511311,4639228.61587531
1,20,5,0,2,7,14,2807144.89815929,9357241.10651922
0,26,4,2,2,0,8,2367521.59823623,8543181.34273681
0,12,5,2,2,0,9,1768128.57545919,4285342.19098912
0,27,0,0,2,7,9,1968903.63357572,4496737.36971839
1,23,2,2,2,1,7,1739398.24684265,1304532.86087948
0,33,1,1,2,7,11,2587465.30932944,2085663.65279389
0,17,2,1,2,0,5,1310225.73614866,5372177.2126222
1,35,6,2,2,7,17,1922443.62226209,7090746.76475205
1,35,6,0,0,4,10,1115378.52826435,6280498.36547804
1,21,1,2,1,5,9,2372786.53008934,5378727.85382729
0,18,5,1,1,4,11,2283470.03132408,6648001.04466335
0,24,2,2,1,6,11,2332886.61931679,7538650.93674328
1,19,5,3,1,4,13,2882004.6727134,5089309.3855016
0,21,4,1,2,6,13,2647348.43556243,6306068.52450518
0,40,3,2,0,0,5,1544502.59416117,4268044.1098022
0,26,1,3,1,5,10,2302055.07930787,5863043.2932234
0,26,3,3,2,1,9,1922935.10095996,5276434.16437896
0,30,1,2,1,3,7,2206334.81005856,4451574.77990455
1,17,0,2,1,3,6,1373222.71847923,6477597.62283657
0,23,3,0,1,5,9,1696830.33541265,7070774.62977851
0,18,4,1,1,0,6,1582753.36371382,5547140.02581893
1,10,4,3,1,1,9,1702360.08085066,6102789.41621317
1,40,5,3,2,7,17,2289708.95987112,8771527.65442979
1,34,1,2,2,7,12,2033321.02939329,8756956.10773479
0,15,2,0,1,0,3,1261826.91543173,4325253.40438908
1,37,3,0,1,7,11,1897742.80862119,6327993.87535038
0,10,4,0,0,7,11,2079270.10446908,4245884.68783972
0,32,2,1,1,6,10,1821689.04448713,6491258.42798083
0,12,3,0,2,6,11,1876072.03418574,3842801.0845959
0,17,2,1,1,7,11,2100628.23073785,7479401.69669087
0,29,0,3,1,7,11,1999133.66191314,6123989.48965267
1,33,2,2,0,6,10,2125564.79457883,6285165.73835311
1,27,6,1,1,7,15,1978616.697382,5672637.03847455
0,12,3,2,1,4,10,2004469.06489654,7624163.86547647
0,15,6,0,2,5,13,2227424.53501501,2118026.92360737
0,18,1,0,2,0,3,1621317.92380865,3169977.09464754
1,31,0,2,0,3,5,1474865.7867321,4274800.42609161
0,13,5,0,0,3,8,1478599.92360245,6853123.28648404
0,36,3,0,0,1,4,1204362.08881515,3554468.22617835
1,36,1,3,0,6,10,2400211.96069942,5774314.44984445
0,20,1,0,0,5,6,1874060.60047037,4986985.67930504
0,27,4,3,2,2,11,1755244.51109884,5450872.63583843
1,21,0,3,1,1,5,1835339.66608257,5610709.45911769
0,37,0,2,0,2,4,1437707.00565987,1446868.57185175
1,18,3,1,0,5,9,1853968.50274133,5854065.5921798
0,34,3,2,1,1,7,1477141.35916609,3775844.59003182
0,39,3,3,1,0,7,2003425.44915373,3932768.1204717
0,11,2,1,1,7,11,2971257.06985571,6016427.25569668
0,21,5,0,2,0,7,1980093.60476035,3831337.87697519
0,29,6,2,0,4,12,2748869.40334655,6093997.58878933
0,40,1,2,2,5,10,1383281.67668473,5587839.73469174
1,23,5,1,2,7,15,1826556.5647329,5262359.47529578
0,27,3,2,0,0,5,1512819.93107018,4882925.98805756
1,13,1,2,2,1,6,1029644.34225464,6351738.56523482
1,24,6,1,1,2,10,2431289.83964363,6190503.74243875
0,23,0,0,2,2,4,1531411.8635654,3786904.51338695
0,29,1,3,2,5,11,1764761.5918401,7890217.31042977
1,14,5,1,2,2,10,1197994.89539617,5492060.82466687
0,18,5,2,1,5,13,2263660.3938322,5589536.93106837
0,36,2,3,1,0,6,1411606.53630785,5596824.6324738
1,39,5,0,1,4,10,1636982.36809712,8732199.97291825
0,20,6,3,0,0,9,1670315.03384225,7904290.75379664
1,24,5,2,0,1,8,1630925.45302431,5816261.67003604
0,10,0,3,0,0,3,1501628.99711949,2380089.10437659
1,24,0,3,1,5,9,2053007.014624,6806310.18311038
0,10,3,1,1,7,12,2084702.45001801,7209057.75240202
1,24,6,0,2,4,12,2114021.67738391,8798009.72407146
0,38,3,0,0,3,6,1523329.08334604,5452314.01629263
1,25,5,3,2,4,14,2375927.96840055,8395407.57944179
0,37,5,3,0,7,15,2649451.48024392,9589929.52102618
0,31,6,1,2,0,9,1562264.49382021,4395418.77620749
0,33,0,1,1,6,8,2357694.63127018,5281774.80389152
1,38,1,1,0,5,7,1165369.75482945,1637324.95856612
1,14,2,0,2,2,6,1637088.61815506,3840120.87268527
1,15,3,2,1,1,7,1605223.57716507,9957270.65502838
0,39,5,3,1,1,10,2346014.22777539,7393606.85428322
0,33,4,3,1,7,15,2746648.02536341,9496764.3662792
0,34,6,2,1,3,12,1951433.95104571,6038509.26253035
0,12,5,1,0,7,13,2352943.20774678,9522152.61298394
1,37,1,1,2,1,5,1610072.45668324,5637117.05075753
0,38,3,1,2,6,12,1738429.55147188,7135420.07314319
0,22,3,0,1,4,8,1762918.98418892,5845174.21800097
1,40,4,2,1,7,14,1827374.38626367,11909723.888914
1,11,2,1,0,3,6,813415.657408469,6676616.47122703
0,34,1,0,1,0,2,880153.017843987,3403291.6622419
1,27,3,0,1,5,9,1542611.4920417,7657565.49142324
0,10,5,0,2,7,14,2287185.88722188,6330126.77408549
0,17,4,0,1,4,9,2279180.98260138,6123705.28363748
0,21,5,1,1,3,10,2056077.50216727,6907908.83455229
0,32,2,1,0,0,3,1336086.60632041,5449721.49835823
1,21,5,3,1,0,9,1718566.23867911,4838288.49140294
1,32,4,1,0,0,5,1344307.47135023,2824729.81845296
0,13,0,2,2,0,4,1568181.95839893,7074936.10987055
1,23,1,3,0,1,5,1304841.56340812,4824746.20057581
0,27,5,1,2,3,11,2526464.79174993,6613303.01040131
1,36,6,1,1,3,11,1610508.5823461,1083078.217349
0,21,0,3,0,1,4,1369716.9901507,2009929.06207173
0,18,1,2,0,5,8,1678031.63038271,4608170.53944536
1,36,6,3,0,7,16,2251842.15049364,8228073.82635738
0,32,5,3,0,5,13,2235969.72329558,6398075.2397532
0,24,6,2,0,3,11,2282925.86749915,6671732.38664001
1,30,3,0,0,3,6,1802735.01841618,3525719.9751615
0,24,4,3,1,2,10,1294598.30974219,8363780.86804046
0,17,1,0,2,6,9,1734284.30878021,4470186.05214747
0,40,1,2,1,1,5,1555930.88365254,4163456.91353632
0,34,6,1,0,6,13,2502865.65981874,8770504.75140903
1,30,4,0,2,4,10,1807161.69089128,4270436.69157329
0,35,4,0,1,3,8,1394926.43937778,5227328.78803036
0,25,1,0,0,2,3,842271.53600327,7370756.99271173
1,10,0,0,2,4,6,1656383.17458197,7245954.58481795
1,38,2,0,0,3,5,1975969.21456514,3654297.4325138
1,38,3,0,2,1,6,1311558.45946394,5330949.20660483
0,38,3,3,0,1,7,1568579.97619753,3881523.42863451
1,24,1,1,0,3,5,1378284.40373168,7861093.88076404
1,11,4,2,1,3,10,2012898.31024309,3812373.23938883
1,12,5,1,0,4,10,1990896.39403866,8158284.17172391
0,37,2,1,0,2,5,1306034.74637306,4044137.67258738
0,34,0,3,2,0,5,1588769.41472553,3751591.40699723
0,40,2,0,1,4,7,2109029.31143659,4439144.30564842
1,28,4,1,1,1,7,1887963.61108607,3504742.43498045
0,22,1,2,1,0,4,1561878.15194079,8202655.22509311
1,14,1,3,1,5,10,1908608.13648556,6578903.72690881
0,21,5,0,2,6,13,1941626.92463069,7135972.92041487
0,13,2,3,0,7,12,2132396.80109746,5892264.50616414
1,32,5,2,0,1,8,1627316.85090694,2680982.32264037
0,32,5,1,2,7,15,2485371.31200147,9172966.23749041
1,27,3,0,0,3,6,1616870.99186311,6041674.7428399
0,26,3,0,0,4,7,1925364.1430244,3962212.86025372
0,33,5,0,2,1,8,1503178.00312104,6736122.64051155
1,39,0,0,0,7,7,1965538.77461179,4902181.36399174
1,10,4,1,2,1,8,2062224.78973983,4317173.83401356
0,16,6,1,1,6,14,1315338.93910822,4294325.1365136
1,23,2,1,0,0,3,1337418.7411148,4527243.62619685
0,16,3,0,0,6,9,1720151.99062738,6794590.30751093
1,34,3,2,0,5,10,2263657.42353793,2010668.90009525
0,24,1,1,0,5,7,1478185.77524573,5710602.12348499
1,38,3,2,1,0,6,1959795.20618392,7201049.2520262
1,30,2,0,1,3,6,1373956.53495938,3464684.38145807
0,19,3,2,1,3,9,1950916.31976339,8987990.74627201
0,35,3,0,0,6,9,1423488.36134674,2874609.30078262
0,16,2,3,1,2,8,1873670.27969752,2822824.36161365
0,11,5,1,1,1,8,2017283.30718295,5449051.78975293
1,20,4,2,0,3,9,1808366.19540147,7381185.57259588
0,36,3,3,0,5,11,2038962.68713004,5276757.90655048
1,37,4,0,0,5,9,2123350.88075376,4291837.0833135
1,31,0,1,2,7,10,1913314.47012473,6095702.03854328
0,36,0,1,1,5,7,1803622.55348429,3917723.2138675
0,15,0,1,2,7,10,2279761.6962051,6733977.82982189
0,27,4,0,1,1,6,1629032.59412145,7383620.32207622
0,11,3,2,0,3,8,1895155.91702058,1794510.33763561
0,19,0,2,2,1,5,1532147.1109709,5740593.67214382
0,13,3,2,1,4,10,1708789.17518105,9027902.03611872
1,21,6,3,1,3,13,2311954.84634266,9363579.27255193
1,25,1,1,2,3,7,1802106.49850977,6852255.79469174
0,12,3,2,2,4,11,2162753.28833649,7683185.26343694
0,36,4,3,2,6,15,2776612.38011994,8454039.1490206
0,36,3,0,0,1,4,1632776.87730194,5593827.42252642
1,16,1,0,1,0,2,1274458.2123216,1996171.19240964
0,28,4,0,0,2,6,1611035.30981342,3679853.78860758
1,30,0,2,2,2,6,1691380.65576172,5117265.28712464
0,18,5,1,1,4,11,2026360.0628335,3338428.93038707
0,40,0,1,2,1,4,1256515.50411559,2416808.17455915
0,25,1,1,1,0,3,907411.971303933,6042772.52813007
0,16,5,1,0,6,12,2082745.52819514,7698499.15418485
0,24,2,2,2,4,10,1759249.63410297,9270402.91510659
1,40,5,2,0,4,11,2341641.57764932,5521337.83453528
0,29,6,1,0,5,12,2206994.82283731,8929188.28472545
0,14,3,2,2,6,13,2531522.5360323,7356945.16804414
0,23,6,2,2,7,17,2947698.16694362,8943680.0273904
0,39,0,0,2,6,8,1579788.09108646,5581019.89009778
0,28,1,3,2,0,6,1524083.65336602,3929123.48485803
1,20,0,0,1,6,7,1872429.02243732,3121367.65219298
0,16,1,2,2,1,6,1159756.38895845,3450791.22679025
1,22,3,2,2,6,13,1851883.40670721,4754750.47030879
0,20,5,1,0,7,13,2488837.206383,5567181.62030999
1,25,1,3,2,0,6,1942845.83044888,6582530.03295062
0,15,2,2,1,1,6,1594711.29028427,4712978.493679
0,16,0,1,0,5,6,1899841.68208365,5048137.3634266
0,33,2,3,0,0,5,1263790.89717235,4180605.35545361
0,12,5,0,1,6,12,2027950.56131687,6630280.3333727
0,28,1,3,1,5,10,1758718.37048299,7120243.46466764
1,39,4,0,1,3,8,1388435.7853932,4586879.37747208
0,39,5,3,1,2,11,1877625.6978859,5516619.46336585
0,10,5,3,1,7,16,2699698.73968957,8093926.80087133
0,12,4,3,0,2,9,1729769.91381407,6670484.15923176
1,19,4,1,0,4,9,1499857.87161096,2993164.8076416
1,23,0,0,0,6,6,1459424.88302288,5360941.13540492
1,20,1,1,2,4,8,1987390.06473837,7556762.15584116
1,18,3,1,2,0,6,1717606.45723858,7970060.16447191
0,15,5,3,0,2,10,1840375.92291321,9283648.90768357
0,40,5,0,1,7,13,2481549.86758897,6339285.64232806
1,31,5,1,0,5,11,2118966.40346915,9288633.23228119
0,13,4,3,2,6,15,2681644.34869446,9981481.22028365
0,10,5,2,0,0,7,1433329.67335443,5610040.31555676
0,10,3,0,1,5,9,1348794.24751262,4020520.98533584
0,36,2,0,2,0,4,1251174.07081403,4857242.82866855
0,16,2,3,2,3,10,1987019.27550211,3095803.50808011
0,29,1,3,2,6,12,2124128.97446722,6544696.954521
0,36,0,0,2,2,4,1375361.49925397,2834662.80621213
0,20,4,1,1,3,9,1534953.46003187,8655871.26741393
0,28,2,3,1,4,10,1698310.56757018,7455853.54695376
1,38,4,0,2,4,10,1669994.25697788,9555325.45283167
0,38,0,3,2,2,7,2003803.10927736,7632364.45161289
0,28,5,0,2,5,12,2086969.82894147,4573731.80459531
0,13,4,3,2,1,10,2338208.95040471,8657873.32790571
0,32,5,1,2,0,8,1753084.73072245,3034068.46844515
0,22,6,2,2,7,17,2436975.90133077,11273701.9097108
0,32,4,1,1,0,6,1833177.38728462,6191084.00755277
0,38,0,2,0,4,6,1552358.52883345,5051782.42941179
0,11,1,0,1,5,7,1666580.32992146,2970512.93021814
1,12,5,3,1,4,13,2082998.28864948,9645288.87865382
0,28,0,1,0,4,5,1827639.2983906,1521689.17751012
0,31,3,1,2,2,8,1691451.18107749,3534768.27709106
1,14,1,2,2,3,8,2416556.65049681,3619710.43788751
0,10,3,3,1,0,7,1349647.19895585,4849016.78515384
1,24,3,3,0,5,11,2788429.83180841,5895298.39005388
1,24,6,2,0,1,9,2008474.21176085,6518576.14235038
0,14,2,1,2,3,8,2216872.62304134,6163821.18589613
0,10,0,2,1,7,10,2029439.98517324,11105916.681454
0,26,0,3,1,3,7,1500513.35786587,1957541.11847031
0,40,5,3,1,5,14,2325820.46858094,8388687.005709
0,27,5,3,2,2,12,2361668.98145166,2512989.73028588
1,37,4,0,0,2,6,1769151.60065196,4897535.31604313
0,25,6,0,0,4,10,1996513.93710143,7632140.83290769
1,33,5,1,0,6,12,2047564.51624443,6356529.06829931
0,26,0,3,2,4,9,1779988.89838397,9275141.48710453
1,29,3,2,2,6,13,2761784.82992367,9436900.99674565
1,29,2,1,0,4,7,1727106.12073498,463942.250319652
0,19,4,1,0,3,8,1684766.64895573,5389041.79319343
0,26,1,0,0,5,6,1245174.24364583,5650474.27395089
0,35,4,0,0,2,6,1445680.43538952,5686100.81929859
0,20,2,1,1,7,11,2746664.53789742,6319185.48004195
0,18,2,2,2,1,7,1541676.00376393,6157069.91135633
1,15,2,2,1,6,11,1941564.23178726,5293039.56374735
0,35,3,3,1,5,12,2049408.64013976,10930863.6410242
1,15,5,0,2,7,14,2464095.22388742,8358184.30298746
0,38,0,2,1,2,5,1821674.50995178,4731334.81606697
0,24,0,1,0,7,8,2077162.14924163,6832219.8160572
0,10,4,0,1,3,8,1997706.96732724,5417900.87295047
0,11,6,3,0,5,14,1510803.01665986,5873119.16169456
0,11,3,0,1,2,6,1725889.02995352,4867789.79985543
0,31,2,1,0,2,5,1265463.58206649,1391124.69605603
1,10,6,2,0,6,14,1574484.2443577,4220339.53739699
0,40,3,3,2,4,12,2408921.24544417,5131998.84269816
0,21,2,1,0,2,5,1124065.91064345,4823228.22779215
1,16,0,1,1,7,9,1844703.88867842,5672607.77544592
0,33,3,0,2,1,6,1406012.80182942,6489750.92202743
1,27,6,1,2,1,10,1501695.65703134,7186330.59668818
0,38,3,3,2,6,14,2800995.54602278,4901050.58438355
0,39,5,0,1,0,6,1180822.60027003,4061562.07023228
1,15,6,2,0,6,14,2648608.2703341,6705675.70831637
0,36,4,0,0,5,9,2169182.10866093,3733712.33911428
1,38,5,1,2,1,9,1466020.42140497,7271029.53493095
1,11,0,1,1,4,6,1410638.20736803,4901435.62197752
0,30,0,2,0,0,2,1053201.66855227,4858062.5329987
0,16,1,3,2,1,7,1932523.44586598,2642840.19751559
0,40,2,0,2,7,11,2411933.28269454,6176813.17074071
0,19,3,0,2,5,10,2062369.58889357,5425726.76193361
1,30,2,3,2,5,12,1720767.31441014,4505964.4460759
0,37,0,3,1,4,8,1371340.79838639,5300230.51068577
0,30,6,1,0,4,11,2168928.37164003,5926998.78789095
0,16,5,1,2,7,15,2692244.6078018,9885055.59648037
1,31,4,3,2,3,12,1863630.09643599,5085336.2875456
1,37,6,0,0,4,10,2749743.37242701,6282648.98661587
1,19,0,2,1,2,5,1470936.20080003,4824611.37490793
1,38,5,0,2,6,13,1742999.14749018,5850493.31538748
0,31,5,0,1,6,12,2068688.08056092,3665057.0919509
0,30,1,3,1,1,6,1733384.4701062,4239117.63638645
1,39,3,3,0,0,6,1506028.76457293,4327493.44560231
0,21,0,1,0,1,2,772884.717055972,5485996.42612609
1,16,6,3,0,7,16,2939516.87035562,9716801.13210726
0,15,3,3,2,7,15,1733461.29735176,7089643.77721865
1,28,1,2,1,5,9,1733178.2252981,5987046.92034247
0,33,6,2,0,4,12,2393684.18683492,6142069.61395465
0,32,2,0,1,1,4,1172227.47981736,4461474.43450252
0,39,1,0,0,6,7,1912733.99116476,5239057.5855983
0,12,4,0,2,1,7,1620810.60781098,3877839.3312616
1,11,4,2,1,0,7,1990452.59521297,3558133.81604276
0,28,5,3,2,6,16,3001811.3686523,10294869.8986163
0,30,1,1,0,4,6,979051.522784287,6937007.21019868
0,32,3,2,1,4,10,2032877.07703472,3633173.54365544
1,18,1,3,2,1,7,1819334.22145759,4602304.8756576
0,35,4,3,2,6,15,2062302.93245518,5883128.59058936
0,12,5,2,1,2,10,1962973.29055834,4635875.09370823
1,40,1,0,1,7,9,1769591.00191588,5086067.24565699
0,18,4,0,2,2,8,1787119.7809862,6162765.24643062
0,37,3,2,0,1,6,1302754.30724163,7057533.69552924
0,23,6,3,2,5,16,2919560.47075431,3890836.70744271
0,13,4,0,0,1,5,1346240.96002316,5030954.75898836
1,21,4,2,0,5,11,1644794.18931551,8576660.44016496
1,32,0,2,1,5,8,1364410.32972465,5980480.49757327
0,37,1,0,0,7,8,1737687.80861647,7715606.16803512
0,21,0,3,1,1,5,1305621.73705038,2820994.2496922
0,34,0,0,1,0,1,1399757.01852244,4886929.61908207
0,22,4,2,2,3,11,2397691.60439832,7118749.67409156
0,12,1,1,2,5,9,1776583.87258869,4516543.87714521
0,22,4,0,0,1,5,1717967.14630028,6071812.05177796
0,16,5,3,2,6,16,2796916.34923037,8715361.16670718
0,35,6,2,2,1,11,2001461.16364588,8027270.91598063
1,40,0,3,2,2,7,1667322.04470898,7061445.19979203
1,27,2,1,2,4,9,1455509.05186478,3266348.59212061
0,19,2,2,2,3,9,2330353.26441672,6618238.27519792
1,31,2,0,0,2,4,1657543.18760158,1593425.20859997
1,39,5,2,2,7,16,1949066.82894434,8144853.44669679
0,32,6,0,2,5,13,2625098.16849847,7675670.29053397
1,24,0,0,2,3,5,1509620.45175857,4789084.83277891
0,14,6,3,0,7,16,2886492.48415607,10304195.7681883
0,25,3,1,1,0,5,1595352.0053143,5521949.58311927
1,11,3,2,1,0,6,2214590.71646031,5114236.4708342
0,22,4,3,0,3,10,1799864.85971876,6852477.57579844
1,31,1,3,1,2,7,1737737.74659692,2323100.73212808
1,13,4,2,1,2,9,2188515.60111605,4090844.79325959
0,12,1,1,1,7,10,1809994.45178281,6740035.99613526
0,39,2,2,0,3,7,1677672.25396432,1515020.33758879
0,25,4,0,0,2,6,1225211.75320005,4306968.26681587
1,13,1,3,2,6,12,2442408.24194423,2504634.78613812
0,17,6,3,0,7,16,2871765.87158572,5288553.85649661
0,35,2,2,2,4,10,2081886.20498901,7740425.80325254
0,19,4,3,0,2,9,1333594.67619342,3727071.39814959
0,23,3,1,2,5,11,2820171.75047743,4605836.98140796
1,36,6,1,1,0,8,2096542.33800627,6516374.68887357
1,15,4,1,2,6,13,2283457.85606119,6581107.95802745
1,27,4,2,2,7,15,2177931.40875384,9242253.44055351
1,17,5,0,2,4,11,2663603.30760927,9351967.56097237
1,19,3,2,0,7,12,2240578.83708173,8244942.85035083
0,40,0,1,1,2,4,1261486.72002838,2535981.9762417
0,23,3,3,2,4,12,2629379.85176267,8873802.04185413
1,40,3,2,0,5,10,1793193.78688711,8042272.83180113
0,14,0,0,0,5,5,1458044.11486991,4530312.45511036
0,31,3,1,2,7,13,2592894.33713625,6811871.62213364
0,35,2,3,2,4,11,1910388.58444108,4063543.36974649
0,17,1,2,2,7,12,2616987.04933303,3659781.89777017
0,35,1,3,1,6,11,2027810.70364968,3584855.23185172
0,25,1,2,2,4,9,2095695.27065229,3318712.00199909
1,25,6,3,2,3,14,2136193.00927649,5946191.834486
1,40,0,3,2,2,7,1539251.56385036,3005449.23303227
0,32,2,3,0,0,5,1444898.93899762,1810517.13807078
0,36,0,0,2,5,7,2196981.7259731,5123608.22414191
0,36,0,0,1,3,4,1752505.77221611,1289968.66163178
0,10,3,1,0,0,4,1685492.99574044,3285336.86838581
0,11,2,3,2,5,12,2618292.75573641,6831391.28154928
0,38,4,1,1,2,8,1960938.52786326,6333321.58730893
1,19,4,0,0,3,7,2013738.37638752,3767904.62904238
0,14,6,0,1,5,12,2919003.16473225,6914223.13898499
0,37,3,1,2,2,8,1683752.70517898,5580300.05628327
0,24,1,3,0,4,8,1848642.46773546,7378829.55514909
1,27,1,2,0,3,6,1423689.19754461,4157517.11989298
0,14,6,0,2,5,13,2629411.20575115,8121363.70114325
0,33,3,3,1,4,11,1921313.02933175,8107531.12244333
1,16,3,3,2,6,14,2375922.83430265,7118428.61050134
0,21,3,1,0,7,11,1422168.4326195,9406921.13724744
0,23,5,3,2,2,12,2227865.19624075,4985308.22321282
1,12,5,3,2,2,12,2296829.96058538,6124074.4472456
1,29,0,0,1,5,6,1935484.48759746,2831404.00840511
0,14,1,1,2,7,11,2125103.8293742,4157699.61542122
1,39,0,1,2,4,7,1925154.02348595,4405612.83679688
0,22,0,0,1,2,3,1450275.9227035,4335565.04206496
0,31,4,0,1,5,10,1704889.6784264,3926710.84103553
0,36,5,0,0,0,5,1348305.6920559,3083312.33591659
1,37,6,3,2,5,16,2259142.26635549,10522065.7983046
0,22,0,0,0,0,0,767485.171955598,2340345.42068154
0,25,2,1,2,7,12,2342207.81495952,7581731.2835325
0,30,5,3,1,4,13,2260528.10063936,4042615.79592751
0,26,3,1,1,6,11,2176996.15995168,5537788.12670879
0,26,5,1,2,7,15,1752875.7614817,9627884.56873301
0,26,4,2,0,2,8,1712946.72906766,10072161.5701129
0,17,1,0,1,4,6,2093182.0809526,2176568.87141277
0,34,6,0,1,1,8,1813361.75215859,2704584.01742786
0,13,1,1,0,7,9,1790512.65397442,5313634.9409855
0,20,6,3,2,7,18,2690370.59156393,8046933.04165782
1,38,1,1,0,5,7,1931930.07366598,3712592.60936666
0,14,3,3,1,1,8,1464070.85981761,7610647.46033281
0,32,4,1,1,6,12,1819852.68964688,7923854.82598951
0,19,3,2,0,4,9,2286847.85171273,3067910.46112271
1,24,0,1,2,0,3,1146486.16329359,3662800.24713642
0,20,1,2,2,2,7,1751608.82034934,4167599.06248056
1,37,6,2,2,0,10,1820138.87450254,5251599.39676397
0,22,1,0,0,7,8,2050135.75694677,5994668.91130508
0,36,1,3,1,0,5,1428398.4563183,1540690.37159934
0,11,0,1,0,6,7,1430127.80263489,5136991.18118976
0,15,2,1,2,5,10,1912940.72555808,6702448.0641585
0,17,5,1,1,6,13,2153535.05249768,4380054.0456938
1,38,4,3,2,6,15,2142001.94606122,4190718.97841735
1,22,4,3,1,6,14,2801159.82528712,6828626.13196295
0,30,6,3,1,4,14,1838362.16025376,7424008.78972889
0,18,5,1,0,3,9,1793548.56106093,4799224.05885722
1,13,4,0,1,0,5,1339465.25775122,6557771.38718705
1,33,3,1,1,2,7,2324912.24805828,3109831.81302154
0,24,5,2,0,4,11,1882065.21443407,5522808.60394166
0,21,0,0,0,7,7,1949293.19358532,4893357.10989656
1,10,6,3,0,6,15,1153511.85177427,7423940.20319176
1,37,1,3,0,0,4,1005031.98729848,6139672.6551905
0,21,6,0,1,0,7,1876179.91462216,3405733.00961889
0,28,4,3,2,1,10,2351165.05146096,4184336.86336118
1,36,5,2,1,6,14,1922493.3625341,8230594.61357906
0,37,1,3,1,5,10,1576825.97315233,4973847.59520967
1,33,0,0,1,0,1,1073844.90165454,4180098.43701652
0,15,6,0,1,5,12,2761986.30690865,8085835.26401894
0,29,2,1,0,0,3,1482097.54907811,3716366.85980465
0,40,5,2,1,7,15,2896588.57751386,8849807.45590932
0,34,5,2,1,0,8,1919473.35333301,2898492.52762082
0,30,1,3,0,3,7,1740387.68742113,5786985.27164785
1,37,6,1,1,4,12,2054047.90212402,8048295.59732205
1,26,3,3,2,2,10,1574096.98034959,6573823.19873801
0,37,2,0,0,7,9,1423988.96867413,4596236.24212819
1,31,4,3,1,3,11,2329244.91126829,2711622.37321103
0,36,1,3,1,0,5,1650967.62026573,4918516.95854827
0,38,0,0,1,5,6,2138320.35252839,3347489.56796602
0,39,2,1,2,0,5,785100.648911269,5752093.94084921
0,16,1,1,2,5,9,1964135.21865252,8684971.81956857
0,28,3,1,2,7,13,3249249.67718379,10298032.1001755
0,24,1,1,2,0,4,1256154.36731854,4795346.88829887
0,25,6,0,2,0,8,1737394.03912656,7129165.26184008
1,19,1,3,1,7,12,1874504.92664921,5405021.11003593
0,36,3,0,2,2,7,2036650.30089329,8433399.41802599
0,30,0,2,1,0,3,1838900.62808234,4425141.66864983
0,26,0,0,1,4,5,1101360.08099015,3100352.05994711
0,27,4,1,1,7,13,2225864.01490296,4552303.94645357
1,26,5,3,2,7,17,2721376.03005204,8431670.90607479
0,29,5,1,2,2,10,1601559.69900552,5338361.1317917
0,17,2,0,1,1,4,1750360.82674272,5867946.77581399
1,13,6,1,0,4,11,2624498.237472,3181898.80259771
1,34,0,1,2,7,10,1558990.00013599,9253854.35157747
0,14,4,0,2,1,7,1848188.73587114,5188974.4102511
0,25,4,3,0,6,13,2718406.59914153,8249605.8646859
0,34,2,0,0,0,2,1080996.16429922,3079241.20294236
0,33,1,1,2,6,10,2203979.26345669,5455269.94067103
1,18,4,0,1,0,5,1303185.27018625,5967322.77094883
0,20,4,1,0,3,8,1880469.98605354,4276820.79130042
1,22,1,2,1,6,10,2328474.94996022,6033523.4271114
0,15,5,1,0,3,9,1305349.41593882,8134953.67354343
0,10,2,1,1,2,6,1318905.41035974,5183052.39925408
0,10,6,3,0,0,9,1661533.38326547,2667899.92579362
0,36,1,3,2,7,13,2227559.07045716,12346609.9498674
0,35,5,0,2,2,9,2347408.71669147,6480930.58344136
0,15,2,3,2,3,10,2133797.48078017,5007087.23757958
0,17,0,2,0,3,5,1550680.61481132,1574158.64279172
1,25,2,3,0,3,8,1847082.87860035,6628529.6289177
0,28,6,2,1,4,13,1959717.45532649,6784675.56231696
0,22,6,1,2,5,14,2274919.74096778,5880819.12602229
1,27,1,1,2,5,9,1945619.15512802,4489214.78755736
0,12,2,1,0,0,3,1180326.65066093,5681573.12139151
1,34,2,2,0,6,10,1721271.32663161,7382277.30666812
1,29,5,0,0,1,6,1955726.55426392,3750274.86533332
0,38,5,2,2,0,9,2030795.17530852,4865629.17716826
0,27,4,1,0,0,5,1617620.23752873,4908664.01328356
0,16,5,0,1,1,7,1286423.79131545,4711925.18506903
0,11,2,3,2,6,13,2794187.88498371,5988004.61979808
1,12,1,3,0,2,6,1596734.94056857,4910137.21297141
0,27,3,3,2,3,11,2044992.65291952,7041225.72965033
1,24,4,0,2,7,13,2589234.79512214,6354383.19134306
1,27,1,1,2,7,11,2247390.28021437,7492328.06792475
0,22,5,1,0,0,6,1699156.8369779,4944734.11620151
0,34,5,3,0,7,15,1562723.15734731,8945343.26676961
1,19,1,3,1,5,10,2745747.49662153,5190851.83323854
0,17,2,1,1,7,11,2614444.47757192,7069860.78173663
0,31,4,3,1,5,13,2091670.89107405,5845636.44082281
0,26,6,1,0,7,14,1876030.32648696,9855542.10484375
0,23,3,2,0,6,11,2097893.47232785,5678101.5010587
0,33,0,0,2,1,3,944814.402096794,4126932.67350521
0,36,0,3,2,7,12,2426604.45926746,5745760.20979922
1,22,0,2,2,3,7,1757394.573209,3089433.18228599
0,25,6,1,2,6,15,2676621.89468647,11525263.444146
1,36,3,1,2,4,10,2587898.2402056,6059692.30480668
0,31,3,1,2,1,7,1942290.09717,51201.8006334442
1,24,2,3,2,2,9,1583890.34042798,5522424.36612806
0,13,0,0,1,7,8,1603004.31460148,8727489.95936092
1,16,5,3,0,2,10,1806874.66618064,6227386.5692312
0,13,3,2,1,4,10,2058293.74195197,9007444.47915931
0,17,6,1,1,0,8,1743094.10352312,6708017.77097177
0,17,5,1,1,6,13,2701477.95732266,4933855.69742475
0,30,5,1,2,3,11,2562583.8377325,8907384.0796735
0,21,0,1,2,5,8,2239305.12190423,3745324.96541671
1,32,1,0,2,4,7,1550627.49401515,3739266.94543492
0,12,4,0,2,5,11,2565469.14036219,6679306.73146139
0,35,5,1,0,3,9,1944510.45688834,9047562.44031757
0,12,5,3,1,7,16,3548723.42256961,7862267.96171381
1,17,2,0,0,5,7,1468794.77494045,7400293.15018497
0,35,2,2,0,7,11,2130959.24395361,8497878.68122112
1,38,3,0,2,1,6,1634873.15066279,5704455.05963617
1,21,5,2,1,3,11,1858733.25364342,4559467.49693127
0,37,4,2,2,3,11,2761390.65513425,4354929.41950192
0,32,4,3,1,0,8,1926342.69384766,4747190.60572365
1,37,4,0,0,1,5,1571396.51283935,5038150.75107511
1,10,5,0,0,0,5,1258794.70161747,6128415.0886004
1,17,3,2,1,6,12,2876718.35752081,5032395.84253601
1,13,5,3,1,0,9,2438620.54340011,2937258.48707417
0,38,5,1,0,7,13,2665901.74516215,9923199.11216505
0,32,4,0,2,1,7,1700588.38070299,6986629.09347783
0,26,6,3,0,5,14,3033044.07971489,8428983.75796074
0,27,5,0,0,0,5,1554518.30498079,7905617.79559949
0,28,6,2,1,3,12,2394388.80177775,12360736.1123281
0,27,2,0,0,3,5,1651874.76494602,2972991.18875301
1,39,2,3,1,2,8,2235693.64737207,6389733.94435486
0,17,3,3,1,1,8,1739650.02246036,7681935.75574649
0,15,2,0,0,0,2,1474822.04230899,370696.180324745
0,11,1,1,1,6,9,2041106.05182901,6835386.45688713
0,40,6,0,0,7,13,2008652.11333278,10274735.840934
1,29,2,0,0,7,9,2275096.19068903,5511146.64614611
0,11,0,1,1,6,8,1346203.00577284,5522230.3873433
1,32,5,1,0,0,6,1680425.91313076,5222404.99832775
1,27,6,2,1,3,12,2027784.4031394,10294223.6403612
0,26,5,2,2,4,13,2319876.84239159,5333068.25803749
0,19,1,0,1,6,8,2054050.85529914,5789242.88865789
0,20,6,0,0,6,12,3092265.55725285,7818673.24178187
1,12,4,1,2,3,10,2754602.8255575,3082361.36152974
0,33,0,3,1,6,10,1899625.33855936,5742739.67330522
0,17,1,3,0,4,8,820202.244938382,5566316.26103364
1,39,6,2,2,0,10,2037827.20535841,3202601.77213601
0,25,2,3,2,7,14,2669449.60419529,5955011.74646311
1,10,4,3,0,3,10,2316049.34594351,7379002.08171224
0,16,6,1,0,0,7,2286756.28375727,5178702.04713332
1,29,4,2,1,7,14,2457911.36138596,7637038.60013745
1,26,4,0,2,4,10,2167999.8023338,6927284.70697759
0,34,4,1,1,3,9,1551559.90099187,4772128.05594818
0,28,0,2,2,6,10,2152396.28789547,5509283.25858849
0,21,6,1,2,6,15,3022735.37442493,5819687.07483227
0,32,0,2,1,4,7,1518419.08989133,3941987.71204879
0,21,3,3,1,0,7,1733238.46689142,5786257.9889339
1,23,0,1,2,3,6,1898888.45754167,4650445.83617958
0,21,5,3,1,4,13,2564570.72342549,8819605.44274856
0,20,1,1,0,0,2,1078927.80454412,3342850.6187932
0,36,2,3,0,1,6,1034505.90227042,5815400.26791776
0,17,3,2,0,5,10,2391200.65451239,9736313.27956538
0,12,1,3,1,6,11,2421007.80569153,7522286.0923291
0,32,3,0,1,3,7,1918929.75353508,4521941.86949663
1,38,2,0,1,0,3,1609480.36173502,3541654.07250069
1,21,6,3,1,4,14,2600079.61865499,5845659.71921747
0,36,0,3,0,3,6,1153773.5091714,5578888.15152207
0,32,6,0,2,1,9,2009978.11198877,3570260.61782876
1,15,4,0,1,6,11,1908550.79766182,5206853.36339373
0,40,5,1,0,0,6,1948266.3813131,2753635.49327489
1,10,2,1,0,2,5,1329191.84509443,4261198.63744936
0,11,2,1,1,6,10,2364105.78747382,6782054.13604158
1,32,5,0,2,3,10,2154211.46668158,5678727.65764028
0,20,1,0,2,1,4,1365010.38570057,2038247.57470933
0,40,1,3,0,7,11,2268572.79984919,8063550.89446449
1,36,2,3,0,2,7,1601916.01083225,4738168.62142953
1,33,2,1,0,5,8,1317933.13557353,5082938.53195922
0,30,3,3,2,2,10,1839678.16936653,5786157.08298026
0,33,2,3,0,3,8,2113122.47734444,5036113.17314573
1,30,6,1,2,1,10,1824054.90031822,7835811.7614782
1,11,2,3,1,7,13,2240578.34402817,9322882.90184202
0,28,0,3,0,7,10,1966086.51091803,5880052.04313762
0,31,1,3,2,4,10,1997978.87557474,9684374.41413761
0,32,4,3,1,7,15,2632756.57393392,8129133.38385059
0,10,0,2,2,1,5,1678773.44376082,8688741.57980031
0,27,6,2,0,2,10,1756514.4607213,7702360.18233358
0,34,0,0,2,4,6,1796398.86326771,6016409.98866179
0,15,0,3,1,3,7,1447127.17494461,5129079.73960678
1,34,1,0,1,7,9,1943827.48825817,4706902.57651769
1,27,0,3,1,5,9,1487211.45111717,3777829.26770246
1,33,2,3,0,4,9,2224249.21058859,7207115.89196781
0,34,0,1,2,6,9,1767633.9383887,8049400.22310263
0,17,1,2,0,5,8,1577845.69073218,5666600.63469064
0,38,1,0,2,1,4,1418569.21859818,7217236.74113431
0,13,2,0,2,1,5,1911544.62991697,4544706.86778303
1,29,5,1,1,7,14,2248433.36240659,8849844.17763113
0,16,1,2,0,6,9,1299197.43849062,1829522.95690668
0,10,6,1,2,7,16,2681284.92176227,7881134.63611056
1,25,2,2,2,3,9,1918105.87422587,4702511.59831954
0,35,6,2,0,6,14,2975075.40017537,7732401.45004674
0,23,1,1,1,1,4,947709.646338166,5164078.10159273
0,31,5,1,1,0,7,1365434.70203718,4646671.84525362
1,11,6,0,0,7,13,2077572.62545186,3896308.21277472
0,11,3,2,0,4,9,1974580.66624107,5043405.99263114
0,35,5,0,1,1,7,1726444.57829802,5045470.85182866
0,12,1,0,1,6,8,1775135.13388212,5052394.78171974
0,33,3,3,1,5,12,2633071.98414981,9058998.75570567
0,38,1,0,2,0,3,939420.494649844,3953579.4093432
0,20,4,2,2,6,14,2579218.83513027,4032750.46002635
0,29,2,2,2,1,7,1666685.00054372,6947600.86818277
0,20,1,2,2,7,12,2046424.55436004,4665545.05250781
0,10,3,0,2,7,12,2585249.76606225,8261588.4484075
0,27,5,2,2,0,9,2486056.88104786,3989104.56775772
0,16,0,3,0,7,10,1932590.65142486,9001216.40643577
1,18,4,0,0,4,8,1829905.33850209,5013184.50132484
0,24,3,0,2,2,7,1770426.37932178,6261705.37201659
1,17,0,1,1,4,6,1865367.65385837,6310483.25204188
0,30,1,3,0,2,6,2056045.44343438,4025606.10376756
0,23,3,3,1,3,10,1636024.10812557,5755258.26998739
0,40,1,3,0,6,10,2095538.10965054,4884349.3115984
0,10,1,0,0,1,2,1393308.62287659,4919800.97732335
0,17,3,1,0,3,7,1710465.74616038,5373746.0207744
0,20,2,0,2,2,6,1458525.46164615,5564767.98259671
0,39,3,2,2,6,13,2147861.63330376,5684914.16082518
0,19,6,0,1,6,13,2063925.99782025,11679399.7786093
1,19,0,3,2,3,8,1909214.43548138,3884198.3862728
0,40,3,2,0,1,6,1473123.81369425,5532331.04724213
0,38,6,3,1,7,17,2156763.60434032,6563482.87217472
0,10,4,0,1,1,6,1668276.69222585,9177516.05110696
0,16,1,2,0,5,8,1434299.66487711,8183909.64762842
1,31,4,0,0,3,7,1774472.24274376,2988055.83345843
1,26,5,1,0,4,10,2166867.39858192,5083315.49321024
0,11,1,3,1,3,8,2002717.35501879,6209144.94550291
0,39,5,1,1,6,13,1557962.07372725,9641937.24109854
0,38,2,2,0,2,6,1492347.28051397,3745501.880279
0,26,2,1,0,4,7,1396576.81339646,3797939.05998799
0,20,1,0,2,3,6,1464478.72714855,4617340.1257036
1,24,6,0,2,4,12,2211152.76200763,5140538.3577577
0,22,4,3,2,1,10,1530850.92362302,4144284.08843715
0,32,4,2,2,0,8,1764444.61888054,4494389.54576908
0,34,4,0,0,7,11,2357226.92155811,4444933.09509343
0,18,5,2,0,7,14,2711932.93426345,7933745.96860552
1,39,6,1,1,5,13,2998070.27248917,10219053.8751312
0,15,4,1,1,5,11,2436430.61198241,4230944.72951921
0,21,4,1,1,4,10,2205902.83629766,6737438.49978331
1,11,1,3,2,6,12,1480586.87317916,4963950.0803857
0,19,3,2,0,0,5,1402555.30069418,924018.82218189
1,38,2,3,0,7,12,2156495.27605699,5616088.31035614
1,31,4,3,2,6,15,2703890.75289469,6944716.62591541
1,39,6,2,2,0,10,1770550.12339906,5454251.12717533
0,32,4,1,2,6,13,1996531.96389585,7104435.12782249
0,31,4,2,2,5,13,2409895.12369043,6142563.74612655
0,28,6,0,0,1,7,1557198.22782845,6148072.9532085
0,23,1,3,2,4,10,2126838.50409933,7425474.29107522
0,10,2,1,1,4,8,1435851.88978642,3129817.61332443
0,15,3,3,0,2,8,1636157.69367636,7506161.83503294
0,30,4,3,2,7,16,2566599.90382479,8874025.74802518
0,34,3,3,1,7,14,2550086.77714409,3286869.64722737
0,32,1,0,2,4,7,1729260.55943149,2702561.57124938
1,23,6,1,1,7,15,3470309.02538348,9319371.56118532
1,12,3,2,2,7,14,1847554.56909657,12024889.8363447
0,10,3,1,2,0,6,1917699.77128137,5111470.06525781
0,23,5,0,1,0,6,1413375.57248877,7699667.27757041
1,28,5,0,2,0,7,1958062.66267033,4928598.47673793
0,16,1,0,1,6,8,2260379.87350804,532831.167174096
0,28,5,0,0,6,11,2244983.08535381,8902134.95331201
0,39,3,3,1,0,7,1096781.31160513,4986573.40559163
0,19,3,2,0,0,5,1250489.31036428,4902945.9868617
0,12,3,3,0,5,11,2372724.18625908,2446666.25904508
1,15,6,3,1,7,17,3025027.25795338,7844108.04583274
0,21,1,1,1,7,10,2418269.38792074,8320121.09800548
0,20,5,2,0,2,9,899855.90431291,8714168.59107063
0,29,2,3,0,4,9,2322489.49682277,5593690.26460171
0,15,5,0,0,3,8,1366049.53918093,3659002.89770021
1,23,1,1,2,5,9,1951864.54694932,5543380.98410631
1,16,3,1,2,2,8,2194038.91077665,5435325.49455244
1,26,3,0,2,2,7,1292633.81043225,4658099.92299556
1,15,5,3,1,3,12,1431889.83280128,4484658.66673031
0,32,1,0,0,0,1,1235800.73758135,2021353.15343591
0,25,4,1,0,0,5,1227676.63741038,6272728.17865422
0,17,6,3,0,5,14,1978900.82062273,10071578.202411
0,30,4,0,1,7,12,2249514.09012263,10521433.6660956
1,18,5,0,0,4,9,1806387.41266709,3483396.28045534
0,37,0,0,0,2,2,1416262.34362847,1697174.72031517
0,28,2,1,1,6,10,1623111.44939797,6450127.59946134
0,32,4,1,0,7,12,2570286.06326594,8467640.99211077
0,40,3,2,2,4,11,2463832.44233525,6920459.54945498
0,14,5,3,1,2,11,2350078.84025491,6542887.89751794
0,40,6,3,0,0,9,1663411.20444862,7482612.75210334
0,39,2,2,2,6,12,1937157.29275399,6172403.35820677
0,16,5,0,0,4,9,1733060.56458481,4175415.28809806
0,32,1,1,2,6,10,1740859.81950874,3327782.11333073
1,31,1,0,0,1,2,1266908.33821665,4660397.40926045
1,13,1,2,1,3,7,1571502.69552485,7047270.35720607
0,26,6,3,2,3,14,2728555.86244119,7800513.26678099
1,23,6,2,0,6,14,2445774.29572839,5399871.75766584
0,28,4,0,1,6,11,2519256.5895559,5334461.61156488
1,37,1,1,1,6,9,2139011.29422021,5887804.4046155
0,33,4,3,0,2,9,2310407.92379094,4105071.46099736
0,31,6,2,0,7,15,2487773.44304005,10307959.69238
0,14,2,2,0,1,5,1494601.32487598,7619754.50162516
0,19,1,2,0,7,10,2046037.50231074,4929084.67357728
0,39,2,3,2,3,10,1707221.23080702,6651626.74680226
1,23,5,0,0,1,6,1906638.29629608,5998601.14647843
0,38,6,1,2,4,13,2460871.07360676,3636967.6421011
0,34,5,2,1,1,9,1920086.20163505,4056330.36664785
0,24,6,2,1,1,10,1699828.05381597,7816591.76355372
0,34,4,3,2,3,12,2305446.81087434,9956794.10949132
0,10,5,2,0,6,13,2237020.20395428,11316234.2394195
0,14,5,2,2,4,13,1702188.7682063,6315539.43699974
1,12,1,0,0,5,6,1970063.74211425,4788468.78981028
1,19,6,2,1,1,10,1454618.17210648,9687477.30605741
0,17,3,1,1,0,5,1615936.68260132,3450942.90364048
1,21,5,1,1,1,8,2060630.80819118,3901746.05663295
0,26,1,2,1,7,11,2589492.88572269,5217678.94719751
0,10,6,2,1,1,10,2707236.21237573,4400056.38936192
0,37,6,1,2,5,14,2358054.04030434,8263220.95457225
1,31,5,0,2,2,9,1425197.41436445,4248611.99881939
1,32,1,1,0,1,3,1787765.43513052,4433276.27357077
1,40,2,1,2,4,9,1644956.02452714,7701548.97165746
1,20,2,1,1,7,11,2060406.78873317,6724302.96855712
0,24,0,0,2,7,9,2067718.99651781,5880604.01036588
0,40,2,0,0,0,2,1150127.60523403,3170094.18174354
1,21,0,3,1,5,9,2124542.84079759,2295292.13819639
0,28,0,2,2,4,8,1546411.65479574,4778454.90507846
0,17,2,2,0,5,9,2164190.3057364,5434052.31060614
0,17,1,1,0,6,8,1898727.37628838,6019981.7424151
0,33,5,0,0,2,7,1190796.73683011,5624246.85078588
0,36,4,3,1,2,10,1778223.62559065,8304953.26294597
1,10,2,2,0,0,4,1259502.03824319,3953975.30934452
0,23,6,2,1,3,12,2698732.72358483,9080463.74893514
1,10,0,3,0,3,6,1736481.2126942,1408840.89776038
1,32,4,1,1,4,10,2772232.54970728,5342883.63043254
0,32,1,0,0,7,8,1669696.81703119,8281418.21234698
0,24,1,0,2,7,10,2014982.75026365,4744817.65006013
0,39,2,3,0,7,12,2083221.90312896,6898113.32987807
0,38,2,3,2,7,14,3216317.04260267,7422053.61452814
1,23,3,1,0,1,5,1759824.44652402,6971326.0395119
1,23,3,3,2,1,9,1328464.5510517,3965052.34613803
0,38,4,3,0,7,14,2196907.56380541,10607525.0552154
0,34,5,0,0,0,5,1386152.56501897,6231707.25047893
0,32,6,3,1,1,11,1614882.82611041,5406314.32432933
1,30,5,3,1,6,15,2616593.96674357,6315044.88431797
0,20,6,3,0,1,10,1976721.18335455,5567900.20941579
1,20,4,0,1,2,7,1991793.8878622,3057688.6161392
1,15,1,3,0,6,10,1887368.32705044,4867949.49171895
0,11,0,1,2,0,3,1063174.71364148,4678915.20083309
1,26,6,2,1,0,9,1864261.73144474,4837568.37105685
0,23,4,2,1,1,8,1819481.84552124,5636792.31669932
1,36,5,0,0,6,11,2242034.94452876,6982377.13208425
0,36,5,2,1,7,15,2795842.62608478,5863477.90877557
0,17,3,1,0,4,8,1285932.7241634,6829669.57740833
1,33,4,3,0,1,8,1720825.96544365,7152759.61587526
0,33,4,0,0,6,10,2012264.17966869,7040228.64610217
0,13,0,0,0,5,5,1543775.08456536,3897653.4645007
0,24,0,0,1,4,5,1156232.06437349,2258934.44384196
1,28,0,3,0,2,5,1720838.87426989,5488460.57848836
0,38,2,3,0,5,10,1707924.79932258,6334200.64090825
0,20,0,3,2,0,5,1095054.17287026,5381762.91280385
0,12,1,3,1,6,11,2160746.38692974,4726203.04981599
0,30,0,2,0,5,7,1809428.19196688,1514358.44711155
0,32,1,2,2,3,8,1963013.65950168,4180704.89887803
0,17,2,1,1,4,8,1368784.8676408,5121774.85308533
1,15,3,3,1,2,9,1890055.23054012,3828704.3325248
0,36,5,1,0,6,12,1919780.88754036,1954367.58135907
0,31,0,2,1,6,9,1899274.36150979,4843127.82933899
0,38,6,3,0,7,16,2131307.32140109,8499039.85023934
0,26,4,1,2,1,8,1692811.93743542,9014824.47630838
1,33,4,0,0,3,7,2186309.47301225,3949612.04776972
0,39,0,1,1,2,4,1312839.48871836,4408507.25336233
1,23,1,2,2,7,12,1887991.24140493,7857773.8951892
0,27,6,2,0,6,14,2189072.86063808,5702322.81416665
0,15,0,2,0,0,2,1067102.36721012,3271203.64728911
0,34,5,3,1,2,11,1445484.63996302,8206745.15471149
0,18,5,1,2,3,11,2510404.79144367,2955609.7503539
0,37,6,2,0,4,12,2431244.47659216,8561464.30206997
0,21,5,0,2,1,8,1874189.68683036,4435165.52018267
1,16,6,1,2,5,14,2676145.84642884,4438643.95480377
1,11,4,3,0,6,13,1662396.5395101,6637526.21138052
0,12,3,1,2,4,10,1611891.35603206,5146355.85682332
1,24,4,1,2,0,7,2045437.0974316,6801763.0466713
0,15,1,3,2,6,12,2502323.09873371,6818293.43507496
1,26,5,0,2,2,9,1750753.15838786,4441505.84373135
1,34,1,1,0,2,4,1169404.40654899,6992371.5561435
1,37,3,1,1,4,9,1544571.97404769,3803335.35762868
0,26,3,3,2,7,15,2729751.85867371,5407450.65730755
1,33,0,0,1,5,6,1800543.62959327,5178680.92761544
0,32,0,2,2,4,8,2025087.26947024,5416369.04786959
0,17,2,1,0,4,7,1504073.80069917,5703820.34854524
0,26,4,1,2,1,8,1754183.07831273,6582874.35607341
1,37,2,1,2,7,12,2118770.05655664,5048720.30321723
0,30,1,0,0,3,4,1461356.24173349,4309331.08211623
0,37,3,0,0,1,4,1556695.37892637,3520631.21912764
0,17,1,2,1,2,6,1353937.45653054,2440423.73897197
1,35,3,2,1,3,9,1483795.86965397,4975610.31381119
0,19,2,0,0,2,4,1551223.1918685,6537831.62733569
0,30,3,2,2,1,8,1448052.15275031,6656771.90245619
1,13,3,2,1,1,7,1510367.87898058,7361898.86264446
1,35,1,2,0,1,4,1247391.09905945,3197183.86304286
0,28,2,2,0,0,4,1336723.81003221,5593947.65895303
1,17,4,2,2,6,14,2269806.18459588,5396415.68211464
0,10,6,0,1,2,9,2023692.41536093,6667165.11651894
0,23,1,2,2,0,5,1583296.8536004,2736426.99306353
1,10,2,3,1,5,11,1931356.42933074,7229370.17759103
1,24,4,0,0,4,8,1775881.62843533,6246967.40521388
0,32,1,1,1,4,7,1824902.11383121,4514525.20482933
0,33,0,0,0,5,5,1775971.36234032,5750631.18393828
0,38,6,1,0,7,14,2799703.59490253,6034646.93193492
0,27,3,3,2,7,15,2325015.46551343,6438492.08431561
0,32,4,2,1,6,13,1876508.80694811,8754410.1935664
1,35,6,0,2,6,14,2230394.72142949,6073648.81117794
0,13,3,3,2,3,11,1702456.61359155,5837283.04771577
0,16,2,3,1,1,7,2139279.29754668,3944107.81820218
0,32,2,2,0,7,11,2777337.89505735,8529362.83149212
0,34,0,3,2,6,11,1881500.63083583,7018718.49391765
1,28,3,0,0,7,10,1851641.07492841,4351395.99727978
0,11,2,3,1,2,8,1765423.79819034,4782232.1625507
0,30,6,0,1,1,8,2245708.52655767,5946005.15229163
0,13,6,3,1,5,15,2225999.11387626,8329919.51076569
0,38,0,3,2,1,6,1492348.61567068,4005006.55690975
0,20,3,2,0,3,8,2268396.37879877,4269829.54517667
0,23,1,1,1,5,8,1775522.44542134,6464800.28308417
0,25,1,2,1,4,8,1792300.54202747,5778056.55899518
1,21,3,2,1,4,10,2174925.43411823,4310339.86974993
1,40,3,0,0,2,5,1408358.46253882,4191261.86208509
0,28,4,3,2,2,11,1937009.81876211,4365404.45983659
0,36,3,1,0,2,6,1196577.22111785,2909585.65785284
0,17,2,2,0,3,7,1654987.52432479,7500878.01256103
1,10,0,0,0,6,6,1274589.51592097,5062744.73579011
0,20,6,1,2,2,11,1767985.27424643,7357151.38241019
1,29,5,3,2,5,15,2524284.32691292,10740471.0873876
0,37,1,1,1,0,3,1422835.7224508,5437291.14288761
0,19,2,0,0,0,2,1316121.2459332,4908351.21467601
0,25,4,3,0,4,11,2202460.90561041,8736997.00562282
0,26,3,1,2,1,7,1419356.49376449,2762625.89116314
0,32,0,3,2,5,10,1831009.18727231,8035064.12657157
0,22,6,3,0,7,16,3054888.77786198,14546223.9782302
0,26,6,1,0,5,12,2695812.81595653,7186268.8971552
0,40,2,1,0,1,4,1548574.38337803,4210208.71127371
0,14,6,2,2,5,15,2429640.21686229,12466837.7264445
0,31,0,3,2,4,9,2578706.77327097,5005558.54774511
1,32,0,1,0,2,3,1099382.30994702,1917565.46403268
0,26,3,2,0,0,5,1448619.98455781,4005111.92535232
0,28,6,2,0,0,8,1620631.03587751,4787988.68395526
1,23,0,2,1,5,8,1787551.69308787,865789.831645075
0,21,0,2,0,0,2,1747721.57256415,4971489.79684922
1,18,6,3,0,6,15,2716610.63332812,9863705.66400513
0,26,1,3,0,6,10,1675895.20019779,7077092.10844134
1,34,4,3,0,7,14,2234038.0143785,5395734.79272518
0,27,0,3,2,7,12,2394608.39103431,10195556.3356055
0,29,3,0,2,0,5,1363250.75119088,5030174.13630507
0,26,4,2,0,0,6,1387017.08513365,4481106.13598674
0,29,4,0,2,0,6,1450444.2563167,4450026.66830122
1,39,3,2,2,1,8,1587487.99590178,6565511.11324482
0,39,4,3,0,3,10,2052821.80448111,7671723.62034638
0,31,1,0,1,5,7,1676997.0304729,5698119.13393814
0,37,2,3,0,4,9,2409208.61193913,4192056.86753893
0,20,3,3,0,0,6,1765252.17664602,3435816.81259169
0,30,0,0,2,2,4,1447258.0535483,6652525.65964853
0,38,0,2,1,2,5,1083546.5464922,4569658.03624083
1,12,6,3,1,2,12,2080715.68253051,9214890.12623757
0,31,3,1,1,5,10,1864680.09193889,9637167.49193618
0,11,0,1,1,5,7,1447055.92439548,2474513.43140716
0,40,5,1,1,3,10,2280837.30908342,6894243.00190089
0,16,5,3,2,0,10,1422167.26159198,5819629.16596198
0,15,4,2,0,5,11,1816256.89330728,2350648.62158574
0,26,2,2,1,5,10,2211412.04642725,6655359.47542548
0,10,1,3,1,6,11,1986437.26377867,5524388.71765984
0,27,4,0,1,0,5,1712325.85869747,6770660.76534919
1,34,2,2,1,2,7,1250553.43190034,7458420.4825422
0,39,6,3,2,7,18,2431128.26907712,3314842.79250891
0,13,6,1,1,4,12,2200052.7927667,7318297.54699707
1,18,5,1,2,4,12,2547077.34311178,6476321.9738647
1,33,6,1,2,1,10,1999827.62399395,8393431.70164947
0,13,5,2,0,0,7,1398245.2494816,6836464.92800847
1,32,4,3,2,5,14,1601903.36405278,8342074.32003568
0,29,2,0,2,1,5,1482542.9716002,6371639.85746633
0,22,0,1,2,6,9,1547691.5620829,4348403.96941624
0,35,0,1,1,4,6,2023512.58609697,5554549.55751931
1,21,5,0,0,3,8,2039808.52873073,4970329.29632922
1,22,4,0,0,6,10,1804272.61451424,6784041.48128846
0,36,6,2,1,4,13,2642100.08256511,6918879.7030889
1,34,1,3,2,3,9,1630312.17475436,6604759.31906209
0,12,5,2,1,0,8,1547365.99927434,7130666.18128688
1,22,0,2,0,5,7,1780081.58678642,4839144.903569
1,22,1,2,0,7,10,2309761.24389388,5307676.02674014
1,22,2,1,2,5,10,2096614.77414969,5461331.5217708
1,14,1,2,1,2,6,2001443.7411912,8291287.37257515
0,31,6,3,0,3,12,2390089.25617399,6322057.0538099
1,11,5,1,1,3,10,1889587.81889438,2304625.26748716
0,38,1,3,2,4,10,2187923.37515182,7484408.33943211
0,31,4,0,2,4,10,1383954.67552572,5040992.81714084
0,19,3,1,0,1,5,1611831.56780121,4959324.93666195
0,31,3,1,0,0,4,1063995.78092305,6815269.47448265
0,25,6,2,2,5,15,2621340.25762044,9689122.23317892
1,33,1,2,2,4,9,2022305.3513952,3786522.73410575
0,39,0,3,2,7,12,2282386.09661547,8746109.29374168
0,12,6,0,1,7,14,1873923.73505914,6113667.12795912
0,40,0,2,0,1,3,1200402.44745669,3180653.35008985
1,35,4,1,2,6,13,2283135.93220478,9133017.33734651
0,30,2,1,0,5,8,2117615.43318464,4902645.68959178
1,11,6,2,1,2,11,1951055.54655957,7966736.87805769
1,35,4,0,1,0,5,1685888.61465729,3960318.29366195
1,19,6,0,0,2,8,1817976.64492541,6722018.75953916
0,37,3,2,0,1,6,1684638.80614944,5697009.98261806
0,37,4,0,1,4,9,1708219.49879706,3569634.40236862
1,35,4,0,2,4,10,2158024.14836325,9526014.59524197
0,21,5,3,0,3,11,1233875.59747456,6234186.93924572
0,25,2,1,1,3,7,1916204.18127746,5817344.37686815
0,30,3,0,0,4,7,1657982.72125194,6982060.08030176
0,16,2,3,1,3,9,1778869.26033557,5442038.9084453
0,30,0,0,2,3,5,1058286.07043733,6040244.66959725
0,18,6,1,2,7,16,2342988.17142102,8858128.81830582
1,28,6,2,2,1,11,2310929.57629289,7860753.20211414
1,18,2,1,2,1,6,1937078.62913176,5979761.44175978
0,21,0,0,0,7,7,1641440.91439033,3519008.28132073
0,19,1,2,1,7,11,2290522.66736682,3749239.50090813
0,12,5,2,2,5,14,2057598.52617019,6845904.88468059
1,16,6,1,2,2,11,1680366.92499459,7254195.59198138
1,26,0,0,0,7,7,1375727.26463075,4734028.54973661
0,12,2,0,1,4,7,1274388.95602639,5912514.77453999
0,30,6,2,2,6,16,3867106.14038649,9875886.08370316
1,25,2,0,1,4,7,1673459.28160022,6244106.07835727
0,21,4,2,2,1,9,2260171.67052532,5145593.67347669
0,10,6,1,0,0,7,1802962.36468978,4856105.74449032
1,40,3,1,2,3,9,2212029.85823872,4621764.80085643
0,25,3,3,0,1,7,2013886.78718201,6271106.42405016
0,30,2,1,1,7,11,2477433.26177662,8841366.0243218
1,40,2,3,2,0,7,2162122.48529357,5309552.45000353
0,19,3,1,0,3,7,1598932.82727268,7286986.10566452
0,21,0,1,2,6,9,2299529.36098829,8247369.83075328
0,39,2,0,0,5,7,1991367.9626955,3747609.48808075
0,21,5,2,1,1,9,1614154.48192468,3655704.54498691
0,32,6,0,2,4,12,1517182.05259961,8564009.62271342
0,14,5,2,2,7,16,3372159.30861327,8774723.30017929
0,20,6,1,1,3,11,2730965.30510235,5906700.00918989
0,28,3,0,1,0,4,1507003.63338722,5368332.73944155
1,38,4,2,0,0,6,1717885.22141258,7281283.72767829
1,35,6,0,1,2,9,2102996.87371079,5757697.64116363
0,12,5,2,0,4,11,2577107.3238829,6844413.85117952
0,25,0,2,2,0,4,1569344.83016335,2426943.80348721
1,18,0,3,1,2,6,2175329.15797448,3537573.76393481
0,25,6,1,0,7,14,2923493.68448016,8020877.49766934
0,15,5,0,2,6,13,2570736.35032168,4377629.17529292
0,11,1,1,1,3,6,1752370.39914238,4730507.54135055
0,29,1,0,2,3,6,2036403.30195307,5458231.81697245
1,33,1,0,0,0,1,815186.944367864,1617422.45932873
1,24,6,1,1,2,10,1903416.47255618,6554049.73718663
0,22,4,1,0,5,10,1803953.92160438,8256212.49357272
0,22,3,3,2,6,14,2498221.33024832,5487225.22529256
0,25,0,3,1,4,8,1793522.28629555,3917642.90094208
0,22,6,1,0,6,13,1845683.77632641,6290471.16949495
0,22,6,0,2,4,12,2486988.02359431,6687583.15927314
0,16,5,0,1,2,8,1545138.01725923,5522684.34468081
0,39,2,1,1,7,11,1946692.7163125,7429358.50364819
0,18,2,1,0,5,8,1866630.13114943,2953648.3108714
0,32,0,1,0,6,7,1729757.85494541,7311773.15119134
0,33,6,1,2,5,14,2378039.06391899,7215011.30241667
1,38,5,1,0,5,11,1815412.54029454,11129395.9674244
0,19,2,1,2,1,6,1361741.29237536,4558955.68277887
1,14,3,2,2,2,9,1357574.3781647,4506601.57355319
0,24,2,3,0,2,7,1887141.23138569,6419575.79538727
1,32,5,2,1,7,15,2897400.25032291,8926039.61904326
0,17,2,0,0,7,9,1919107.31490943,5578333.40813839
0,10,4,1,2,3,10,1658635.45142798,2429265.45230159
0,12,3,0,0,1,4,1422477.38908082,2603400.65239822
0,17,6,2,1,5,14,2761669.01628093,9140455.24518471
0,11,4,1,1,5,11,2383718.83181675,3824132.63372562
0,18,3,2,0,1,6,1298179.78328838,4960211.15801365
0,31,6,3,1,3,13,2861332.12179995,11493567.0604517
1,20,4,0,2,5,11,2186067.27658144,6237213.08377868
0,31,0,1,0,7,8,1554792.83911651,7250092.28146232
0,10,0,2,2,2,6,1438056.31492692,5268115.65357496
0,30,1,3,0,5,9,1754172.28358367,5847317.95585368
0,33,6,1,0,3,10,1587843.66292147,2393752.8765009
0,21,5,2,2,2,11,2222495.47556064,8693479.88966856
0,15,1,3,1,0,5,1516947.91647908,4781885.66093217
0,32,2,1,0,7,10,2117275.06907982,6895436.1517157
0,12,6,1,1,7,15,1943808.74625569,9940705.32069654
0,11,1,2,1,5,9,1550280.86444044,6273303.05671263
0,33,6,2,0,0,8,1699648.20958349,3803755.94349975
0,33,6,1,2,5,14,2532222.71998128,6082918.9616991
1,25,6,1,0,5,12,1807227.94504685,1488663.51959512
1,22,3,0,2,3,8,2079814.23152832,4393147.81768863
0,35,4,2,2,2,10,2255629.86527075,7314920.48986818
1,19,2,0,2,1,5,1579205.42411176,5844258.86517316
0,33,2,0,2,4,8,1626413.39717851,2122767.43572822
0,17,6,1,2,2,11,2507431.69153364,4297354.63778706
0,30,3,3,1,6,13,2360366.36977269,6146626.5398417
0,22,4,1,2,4,11,1931796.31314859,8740080.75760487
1,15,3,2,0,3,8,1367741.75429041,5483815.82913001
0,18,3,2,1,4,10,1513311.33928288,2907310.83747112
0,39,4,3,2,5,14,2479081.80048641,8502893.4414704
0,18,4,3,1,7,15,2275389.43717601,8660977.45931813
1,10,5,3,0,4,12,3317073.48048658,4670642.19185327
0,40,3,2,2,1,8,2066271.33163748,5556013.95214727
0,26,5,1,1,0,7,1873745.87689949,8289279.31500457
0,21,1,0,1,4,6,1640446.78583007,4774861.97285616
0,15,0,0,0,0,0,690627.133598651,1780619.31549509
0,30,5,2,0,4,11,2436408.20195052,6684796.58532603
0,19,0,2,1,4,7,1763519.90819926,3250445.79565239
1,35,6,0,2,7,15,2948100.01589188,9471921.08158984
0,28,2,0,2,1,5,1288751.96928068,4943261.71020537
1,21,3,3,1,0,7,1303468.43506114,6142663.81154659
1,40,6,3,2,1,12,2307334.34389863,6324253.71565035
0,31,0,1,1,2,4,1201380.67173261,6825521.53152185
0,26,2,3,1,2,8,1752297.78721135,4327574.13695017
0,14,5,1,2,1,9,2956843.71768267,6170784.069388
0,26,1,3,1,0,5,1554737.04787853,4708663.88069428
0,40,2,0,0,3,5,1795383.15595611,7395543.78045406
0,34,3,0,1,2,6,1899221.6588253,4750269.30324742
0,30,0,1,0,1,2,902323.843689285,3499037.51865569
0,40,5,1,0,7,13,2379305.2322343,7896423.45666395
0,13,1,0,1,0,2,1224175.71923215,4268306.79940994
0,31,2,2,1,0,5,1374687.0815116,2962492.76948661
0,17,1,1,2,6,10,2435955.98191349,6246980.86634794
0,24,4,3,0,0,7,1521559.48912843,5501104.99979715
0,28,3,0,1,3,7,1861152.02033232,7864598.92243495
0,35,1,0,0,5,6,1360624.10863953,3868692.43982026
0,28,2,2,1,0,5,1879671.20594499,5734704.48826032
0,23,5,0,2,4,11,1938111.50934789,3691522.15934721
1,22,5,1,0,6,12,2118922.93960775,6285825.46750046
0,14,0,1,1,6,8,1297511.00050413,6154335.42435598
1,32,2,3,0,6,11,2593462.69064945,6736410.10761946
1,13,3,1,0,2,6,1046123.86407847,5006102.66913593
1,29,5,0,2,7,14,2430392.67489447,11409495.460168
0,26,5,1,0,2,8,1582167.04329203,5943567.23076846
1,34,0,2,0,3,5,1868900.78738533,5875464.0870936
0,21,0,2,1,1,4,1155398.22660226,5545488.16462104
0,28,3,2,2,1,8,2181442.8830129,3666240.0098717
0,29,6,1,1,1,9,1788229.04638258,10057036.98753
0,38,2,2,2,4,10,2415146.81463556,2683814.5169995
0,38,2,1,0,2,5,1561367.37668483,5936930.5153508
1,19,0,2,0,4,6,1892275.9590967,5929711.67710464
1,24,5,2,0,0,7,1601967.94420647,4443829.77123426
1,37,0,2,2,7,11,2476241.73921707,5728599.81966347
1,32,6,0,0,5,11,1764804.53928665,9353892.93187642
0,15,2,2,0,7,11,2766238.28966535,9397696.39285937
0,16,4,2,2,0,8,2100836.23488277,7305013.29070503
0,40,1,0,1,5,7,1900217.79850121,6792971.26466226
0,33,5,1,0,7,13,2815394.78546207,6243479.58112212
1,19,3,0,2,1,6,1946265.66139529,4139230.02635013
0,12,4,2,2,4,12,2442069.42251739,6294096.44860072
0,11,1,3,1,2,7,1653584.86787358,5150297.93257145
0,11,4,2,1,6,13,2076736.68465072,5786745.98809599
0,25,1,3,0,4,8,1775176.81655399,2727451.3868223
0,20,0,2,2,5,9,1902487.83272723,7076584.35692295
0,31,3,1,2,4,10,2371100.9731753,2962007.14086296
0,34,3,2,2,1,8,2482172.17044957,7418621.92176267
0,36,5,1,1,5,12,1572213.81934127,6622755.99583766
0,28,5,3,2,0,10,2083061.67300847,7768554.83710265
0,17,5,2,2,7,16,2066842.44803041,10227306.57827
0,31,3,2,1,0,6,1613151.00397129,6752340.451581
0,33,5,1,2,4,12,2681060.60069547,7142704.81646005
1,33,0,0,2,6,8,1626688.96164559,3780129.08241633
1,19,2,3,1,0,6,1739930.58945171,4941292.48501793
0,28,1,0,0,1,2,970613.118883399,3516593.78722682
1,26,1,1,2,4,8,1704929.57683346,2126866.68005887
1,31,4,2,1,3,10,1728102.6324153,6874427.1767064
0,21,0,0,0,4,4,1053843.25977428,4710533.18674257
1,40,5,3,2,5,15,1758112.55704398,9426596.06712592
0,23,0,3,0,3,6,1168866.92423712,2365333.43564713
0,23,6,3,2,1,12,2267718.46747774,10009781.5981935
0,27,1,3,2,3,9,2073075.97055163,7302382.71418
0,13,3,0,0,0,3,1641090.58146559,4632487.56353906
1,35,3,2,2,7,14,1882381.48617695,6287255.7754456
0,13,5,2,1,0,8,2298368.08435974,6678612.19100726
1,10,1,3,0,1,5,1248360.113162,3776999.95905916
0,22,3,0,2,7,12,2206072.56896564,4769924.25901559
0,20,3,0,1,4,8,1843074.24566063,2979890.46877411
0,38,6,2,0,1,9,1327748.39989505,5207039.31944975
1,32,1,2,2,4,9,1651214.33193946,5465778.04454266
0,32,0,3,2,3,8,2274283.46564059,4354852.72603336
1,20,5,1,1,5,12,2430560.84072196,4956510.45816172
1,26,6,3,0,4,13,1641209.41390312,7295092.08370205
1,26,5,1,0,5,11,1593340.50120504,6198874.75024723
1,12,1,0,1,2,4,1306379.85793087,4082053.16211217
0,10,0,3,2,5,10,1680515.25805275,3222392.48101022
1,30,0,2,0,7,9,2127755.57789485,4990987.14038787
0,18,2,3,1,2,8,2044282.03851358,6106665.08015865
0,35,2,0,0,5,7,1670440.36049235,6028079.34857552
1,19,2,2,1,3,8,1792557.75297263,4309741.63890081
1,30,5,0,0,0,5,1976718.79317757,4124403.84661679
0,11,6,1,1,1,9,2169677.15898567,4719658.80172666
0,30,1,3,2,4,10,2223683.33526151,5449593.11804878
0,16,3,3,1,0,7,932250.3922594,7417600.60579958
0,19,6,2,1,4,13,2348842.93721322,5873252.87012415
0,37,1,2,0,0,3,728689.692527024,4090054.77533985
0,24,0,0,1,5,6,1411231.0585176,3718487.02810649
0,19,2,2,1,3,8,2071201.02354209,4352747.1737976
1,34,4,3,0,7,14,2269894.2693969,7485563.12400653
0,21,1,0,2,0,3,1582900.47372564,2322019.38860119
1,17,1,1,2,1,5,1612821.12804423,5220218.03043749
0,27,1,2,2,1,6,1895906.13612225,5689941.38559565
0,16,3,1,0,1,5,1640991.10030348,3902660.60832347
1,36,1,3,0,1,5,1511723.92205341,3205922.42145837
0,27,5,0,2,3,10,2265731.76924729,6032774.79532125
0,26,5,3,1,6,15,2027192.54680965,7202786.90757936
0,34,1,0,2,5,8,2083902.40245599,5615887.45516466
1,28,5,0,2,6,13,2425033.32538443,3849744.67839556
0,20,4,1,1,3,9,1887834.92336577,6850902.59816971
0,25,6,0,1,2,9,2053976.14197718,7017239.84749602
0,29,3,1,0,7,11,2401314.15433439,4811746.57175973
0,13,6,2,1,0,9,1765085.13916915,4351534.8118541
0,28,0,2,1,5,8,1552039.31460831,5002942.99105509
0,18,5,3,0,5,13,2426321.55687641,7483656.26528272
0,29,5,3,0,7,15,2355319.91650919,7277660.43939172
0,32,1,0,0,6,7,1617986.01470384,8297282.3387287
1,22,6,3,2,6,17,2947272.072413,5192529.40154175
0,29,1,0,2,1,4,1352181.2848651,4903028.81379714
0,12,1,3,0,4,8,1121146.83030561,5342328.88482716
0,18,3,0,1,7,11,1692002.49709716,5964471.55544351
0,20,5,0,0,6,11,2126711.10969668,6114363.28434797
0,30,5,0,2,2,9,2097682.38495603,8830265.60437727
0,26,3,0,0,7,10,1772450.48232807,5933758.23637391
0,27,6,1,2,4,13,1073597.2711031,7329414.7687783
0,28,0,2,1,4,7,2094407.37060701,3573976.55158139
0,31,6,1,1,7,15,2379814.76910922,6068264.32760656
0,14,6,1,1,0,8,1826263.86721616,6532968.85734744
0,40,1,3,1,0,5,2051503.99134287,616428.641208115
1,28,6,2,1,2,11,2016535.36625999,5866176.62584338
0,32,6,0,1,6,13,1735710.16150152,7827659.70340534
0,19,0,2,1,5,8,1941488.46874474,4915668.15489752
0,29,1,0,2,0,3,1396698.80527132,2869417.91369537
1,40,0,3,0,6,9,2209345.75241592,6403154.55169354
0,20,1,1,1,1,4,1776650.43865947,4719918.9969355
1,17,5,3,2,7,17,2349337.54780816,10692047.6261697
0,34,6,3,1,0,10,2481437.35431079,6780193.98908615
0,15,5,1,1,7,14,1506853.24905268,4830088.59275693
0,12,6,1,2,1,10,2080781.34142831,5582617.51302549
0,25,5,0,1,3,9,1590120.2978598,3217338.12003671
1,37,4,2,1,3,10,1340728.05364035,9288428.52880136
0,13,6,3,2,7,18,2559434.60104137,10231142.1149412
0,11,6,0,1,4,11,1701130.69461373,6086576.42259849
0,31,5,2,0,3,10,1941682.32857719,6445089.8482543
1,20,6,3,2,5,16,2438306.13796411,5979037.18733654
0,29,2,0,2,5,9,2048303.94274888,5994912.88019043
0,28,0,3,1,5,9,1715618.24211114,8075177.43350633
1,34,1,0,0,1,2,1357883.61622849,5468665.49052412
0,29,4,2,1,0,7,1684912.7241185,3720932.83468582
0,16,6,3,1,0,10,2003902.08820586,6394423.98248539
0,17,0,3,2,3,8,1917768.10809508,6523120.52643598
0,38,0,3,0,3,6,2203592.68428291,6886207.46469194
0,32,6,3,1,6,16,3378903.1373813,8826428.17148556
1,29,4,0,0,0,4,1884757.60956624,2445453.54136082
0,17,4,1,1,2,8,1500667.38260646,5416694.48532757
0,12,0,2,2,6,10,1414055.32957246,3939798.07107894
0,14,5,1,1,3,10,2036276.89466723,4379245.68224126
0,21,2,1,1,0,4,1476477.91268605,5919326.15500184
0,11,3,1,0,7,11,1787244.17144259,8011501.50119314
0,19,4,1,0,7,12,2250261.07621915,5706540.92649028
0,24,0,3,1,7,11,1794616.44548117,7546228.2719242
1,33,2,2,1,7,12,2491170.37061826,5114127.91040546
0,13,2,3,0,3,8,2006009.23740657,5154071.10538394
0,23,5,3,0,5,13,2381574.85302022,4038767.51649955
1,22,3,1,1,4,9,1926122.92619414,7841989.73105454
1,38,2,2,2,2,8,2008541.84447651,4449766.16658624
0,26,5,1,0,6,12,1952387.58225471,7216189.74176725
0,14,5,1,1,0,7,1657024.47692162,6765909.86894211
0,19,2,0,2,3,7,1638598.14973253,5524472.48954634
0,25,2,0,0,0,2,1825425.03426068,2386883.45591351
0,17,4,3,0,7,14,2704007.76452198,4578547.45978444
0,15,6,3,1,1,11,1609951.30888251,9938525.1244806
1,24,0,2,2,7,11,2079634.15491429,6061752.95612429
1,17,5,3,1,3,12,1986143.65453857,5618425.34407341
0,18,1,0,1,5,7,1335596.6567016,6239730.70849821
0,28,5,0,0,0,5,1396572.43522676,3728905.17156389
0,26,5,1,2,6,14,2288784.88919832,6815163.42397951
0,14,4,0,2,7,13,1604198.27733826,3965307.15095207
0,27,0,2,1,4,7,1487295.68156011,7402054.3020481
0,35,6,2,1,3,12,2180179.72916666,2525415.82936203
0,28,0,3,1,6,10,2450185.8542602,7657267.5231248
1,37,6,3,0,3,12,1744250.54400026,5501826.38294947
0,11,1,0,2,1,4,846309.599981146,3979548.33983143
0,28,6,2,1,5,14,2498706.42390048,6003818.97741714
1,19,5,3,1,5,14,2548546.41000198,4258543.01666253
1,30,6,2,1,2,11,2455772.37008551,1470165.51857133
0,23,2,1,2,5,10,2022998.11866334,6247302.08333383
0,25,4,1,0,0,5,1646588.04319645,4454521.35276127
0,29,3,1,2,3,9,1651042.99304001,4479581.43587294
1,26,3,2,0,4,9,1584001.41414017,6224808.49677092
0,12,1,2,2,4,9,1834300.08670605,5004042.22733034
0,40,3,0,2,6,11,1887577.24895711,6457105.84729081
0,15,1,0,1,2,4,1340899.11765127,4957763.57461472
0,21,6,3,2,1,12,2229165.47600449,6496311.10129988
0,20,4,1,2,4,11,2024939.65022295,6690825.77509096
0,29,6,3,0,2,11,1976207.78670125,7528132.76228261
0,31,5,1,0,4,10,1995151.33989342,6190293.84851052
1,34,2,3,0,5,10,1919709.72537081,6192725.29925211
0,15,1,1,2,1,5,1742203.26187739,2219716.6648614
0,19,4,1,1,6,12,1874805.72709315,5700459.7294897
0,29,5,1,2,2,10,2394908.79055314,8490526.52132917
0,35,4,0,2,5,11,2217782.04818697,5423971.51349832
0,35,4,2,1,0,7,1862163.52015073,3383979.22081988
0,36,3,3,2,1,9,2065549.20499726,3989046.96278713
1,37,0,2,2,1,5,1653180.18858743,5686488.64675292
1,23,1,3,1,4,9,1880088.94841058,6782575.35272185
0,13,6,0,2,5,13,2845769.92003374,3453565.26019713
1,39,0,2,1,2,5,1360936.87124879,5464346.5655585
0,38,4,1,1,5,11,2477367.06750273,7286609.34554054
0,25,4,2,1,6,13,2211766.49107607,10065162.4741331
0,27,0,0,1,5,6,1711088.41792472,3773845.90201194
1,17,6,1,1,5,13,2096421.43080936,5460458.03341248
0,20,1,2,0,5,8,1190225.46437517,4560385.08326214
0,29,1,1,0,2,4,1447421.60929938,4568172.3891388
1,31,6,3,2,1,12,2240339.58455405,5424969.08696744
0,14,0,3,1,3,7,1732793.78949279,5321911.03700346
0,34,2,2,1,1,6,1927532.9939869,5726453.27515374
0,21,1,3,0,2,6,1795065.80945107,1979921.23835471
0,26,5,0,2,2,9,2702157.60215994,4449576.28168931
1,38,4,1,2,6,13,2085630.76493538,5554543.63341086
0,33,2,0,0,6,8,1664393.66595124,5729934.40809378
0,39,2,0,0,1,3,1072808.30124763,4809838.78485058
0,19,1,1,0,5,7,1733100.19085548,2946636.34252047
0,38,4,2,2,2,10,1592442.88452461,5875094.20648227
0,11,0,2,2,0,4,1971528.46976912,2652383.42886602
0,23,3,2,2,2,9,2216299.94776315,6733054.07662846
0,19,3,0,1,5,9,1656604.22831726,3688638.9739584
0,35,4,2,0,3,9,1887622.28606558,4668010.45622437
0,18,6,2,2,6,16,2444227.32613556,4826713.99582703
0,22,1,2,0,2,5,1490159.35710853,5547004.10442606
0,30,0,2,2,1,5,1269407.32260069,4775576.22190959
0,14,3,2,2,0,7,1665717.16412532,6798676.37952278
0,15,2,1,0,3,6,1995699.1504546,5346575.90565354
1,19,5,0,0,0,5,1719215.34210106,3871778.09287118
0,40,5,1,2,1,9,1727720.61971056,5709322.37832848
1,15,1,1,1,0,3,1129106.55162398,4597354.04468274
0,15,2,1,1,1,5,1589326.43864441,3636856.18255034
1,40,2,0,1,3,6,1297946.54892313,3630004.75592679
0,16,1,2,0,7,10,1823578.06833765,5798006.27283132
0,19,4,1,0,1,6,1606899.27184458,3966770.31951494
1,18,6,3,0,6,15,2745109.38964119,6012194.36776828
0,31,5,3,0,5,13,1862933.15454078,8668988.87891817
0,16,5,1,0,1,7,1783081.78494351,2563622.95202802
0,12,1,3,0,3,7,1897915.98756574,5668388.52239304
0,21,2,3,2,3,10,2253511.79094763,3426756.60526441
0,38,1,0,2,0,3,933944.518703809,4851909.98620938
0,26,0,3,2,1,6,1541206.14017262,4361266.28888902
0,10,0,2,1,7,10,2111946.32559552,4574489.44562509
1,10,5,0,2,0,7,1759917.58191106,3592326.00817764
0,37,3,0,1,2,6,1578088.76039399,5917696.2129818
0,31,5,2,2,3,12,1777755.70743366,6576006.12140996
0,33,2,3,0,2,7,2132801.48361509,3676027.81592801
1,17,2,2,2,0,6,1706933.19237869,4490284.78584153
0,34,3,0,1,6,10,2305463.68311877,6648078.29819981
0,20,1,0,2,0,3,1201208.05841357,5414220.58937399
1,40,2,3,2,4,11,2012131.17329259,5140816.92824045
0,26,1,0,0,5,6,1133625.25904251,1758164.66412645
0,10,0,1,2,3,6,1480318.90289915,5592977.95291069
0,30,1,3,0,0,4,1169835.28974438,3608627.62798077
0,38,0,1,0,4,5,1439035.60979351,6243212.63154357
0,13,6,3,1,2,12,2292531.92442701,5920941.10258671
1,22,4,0,2,7,13,2287208.79355997,6994706.22543677
0,19,5,0,2,4,11,1944363.53632348,5735369.13382994
0,19,1,1,1,1,4,1424065.98805925,4586996.57248991
1,32,2,3,1,4,10,1761039.64749786,6479372.13335465
0,40,2,2,2,6,12,1866448.69400487,8897505.72082312
0,34,5,0,0,4,9,1273013.03909623,4524064.70974037
1,15,3,1,0,5,9,1754649.16981608,4181918.40957219
1,12,1,0,2,6,9,2269930.25448222,6730237.54280369
1,24,5,3,2,1,11,2246806.67679461,6830915.36039112
1,28,6,2,2,5,15,2747267.2453364,8836880.57807375
0,10,3,2,2,5,12,2174975.84338531,4176428.43340512
1,14,2,1,0,3,6,1425312.32521162,4248618.52815713
0,30,6,2,1,1,10,2010819.9222357,6028296.85950666
0,28,1,3,0,2,6,1507936.78864628,6397400.21861609
1,26,3,1,0,3,7,1568710.87415081,3771457.39766161
0,25,1,0,2,7,10,1932130.5933985,5550700.89226956
0,38,4,2,0,4,10,1604711.34253993,4221751.15221277
0,36,5,0,0,7,12,1794657.54607458,5698391.6553197
1,26,4,3,1,0,8,1912267.27687075,4911220.51098042
0,10,6,0,0,2,8,2333670.06783516,7099275.10752112
0,18,2,2,1,1,6,1871364.70714461,2996913.80972748
0,21,4,1,2,4,11,2257754.97590472,3248555.63779638
0,22,6,1,1,4,12,2483523.36151544,7568656.6392231
0,16,3,2,2,4,11,1501728.68966762,4125274.60499328
1,19,2,3,1,0,6,1679321.85452139,3077878.29679695
0,20,5,1,2,3,11,1862103.93221496,5759273.3536591
1,12,4,3,2,0,9,1406727.99264272,4809655.93827476
0,25,5,1,2,0,8,1537997.0300404,6479418.50209364
0,35,1,0,1,1,3,1239950.55401281,4867787.08866106
0,13,3,3,1,7,14,1717857.99931604,6223588.88091027
0,28,4,0,1,6,11,1720886.7257922,6534165.76150157
0,17,6,2,2,2,12,2492764.6121729,7569930.36883803
0,10,4,1,0,3,8,1951127.67568922,4388217.46075442
1,12,0,1,2,0,3,956203.457552119,5747922.04567612
0,38,4,1,1,0,6,1813921.26861939,5894667.85650944
1,15,3,2,1,4,10,1864733.63699319,5911917.34523473
0,38,5,1,2,3,11,2645296.77280691,6287655.22706957
0,21,6,2,1,2,11,2637791.63589496,6065790.63250823
0,24,6,1,2,7,16,2539711.84431235,7224196.75861622
0,36,2,2,2,3,9,1696834.8913497,8090504.56980518
1,40,5,1,2,5,13,1665060.31990636,6399224.55753105
0,35,3,0,0,4,7,1406047.48191576,6629713.31711229
0,21,4,3,0,5,12,2138842.2132349,4034367.30376603
1,33,2,2,1,7,12,1837419.17547254,6129396.53899714
0,27,4,3,1,3,11,2003866.08688173,7207494.80302816
1,35,2,0,1,2,5,1091921.27292011,4065627.62939945
0,25,2,3,0,3,8,1345746.52041676,7495684.44548603
1,29,6,0,2,1,9,2077217.45559396,6306988.96119023
0,35,2,3,1,1,7,2246028.04017162,4690092.3217051
0,14,5,2,2,2,11,1829466.6823126,7873598.57982036
1,26,5,1,2,0,8,2250139.67600719,6882695.39664257
0,20,4,1,0,4,9,1568892.52169583,5167060.45679545
1,14,4,0,1,5,10,2325646.94285875,4476563.45270565
0,16,0,1,0,7,8,1891969.53280389,5978285.70807953
1,24,3,2,0,5,10,1593250.08476362,4669965.18470169
1,36,3,1,1,4,9,1429734.72724604,6713007.0702914
0,36,1,0,1,0,2,1422466.89781299,4582086.47337772
0,10,4,2,1,6,13,2449721.77222128,8941642.0620137
1,10,3,3,0,4,10,1681656.38181217,4514685.56162165
0,30,4,1,0,6,11,2269405.88369073,7696341.11475368
0,13,6,0,0,7,13,2747478.98773428,7985314.07618323
0,13,3,3,2,0,8,2013372.03358692,2241489.06198111
0,35,2,0,0,6,8,1829310.4242063,6081569.44903002
0,35,3,3,0,2,8,1923294.95739068,5141313.26397841
1,22,5,3,0,1,9,1979577.95886381,4745836.42923273
0,20,1,1,0,1,3,1635079.99026867,2057688.18476725
0,20,0,3,0,0,3,908585.44834608,6866106.84669387
0,16,4,0,2,4,10,1573933.28399697,5649071.40347165
0,36,3,0,2,3,8,1841576.73597422,5683723.62772105
0,21,4,0,2,7,13,3164999.7855401,9306474.4814564
0,38,2,3,0,3,8,1857550.71441404,4305655.56647181
0,30,1,2,2,6,11,2319053.85783286,4791621.82617795
1,35,3,0,0,1,4,1652480.76215947,2854736.43615289
0,33,1,0,0,7,8,1265091.8260564,5112600.45438413
1,28,0,2,2,1,5,1597448.31174105,4461390.68148132
0,17,2,1,2,2,7,1972273.05639503,5509353.0433456
0,37,4,0,0,2,6,1964897.85955189,6230278.9347446
0,30,0,2,1,7,10,2404706.41030371,6530010.03535832
1,36,1,3,2,3,9,1835159.63699635,8148507.9149322
0,33,4,3,0,4,11,1871828.17145794,4358930.76809892
0,25,6,2,2,3,13,2512169.00519333,5318787.04373569
0,16,6,0,2,3,11,1872205.83616966,3921561.38942319
1,36,1,1,1,1,4,1362592.11880304,6788865.58410265
0,16,2,2,0,4,8,1614259.51787092,7700957.58277742
0,22,3,0,1,6,10,1489313.42033263,7969785.25884295
1,34,2,1,2,1,6,1672359.61068323,4717956.80496647
1,34,2,3,0,0,5,1277709.33677359,3904244.92539766
0,35,3,0,1,5,9,1929442.22253676,6678647.13420926
0,34,1,0,0,4,5,1902933.70979664,5095538.25800159
0,31,1,2,0,1,4,1364708.54802827,4366473.76032197
1,15,4,2,1,6,13,1672266.4558115,10013538.5506574
0,12,6,0,1,0,7,1646996.72425253,5450342.82236833
0,39,4,3,0,4,11,2784810.13532888,6685972.48114453
1,37,3,3,1,6,13,1778593.15991188,6226501.4355075
0,29,0,0,1,3,4,1424884.66886401,3520870.66333026
0,13,1,2,0,1,4,1238052.72737416,3862204.87366527
0,25,5,2,1,5,13,2028995.31954437,11788944.1526845
0,23,4,0,1,0,5,1503906.40602862,2639230.28702315
1,17,0,3,1,5,9,1841575.47651207,6908740.89707387
0,17,4,0,0,6,10,1567549.79437399,2766770.74460375
1,17,0,3,0,0,3,1070151.95866712,5049203.08148962
0,11,4,3,1,0,8,2411101.93277019,5074591.11493984
0,27,2,3,0,3,8,1639650.22073791,7328333.97471719
0,28,5,2,1,5,13,2993740.8832262,7674498.48875437
0,10,6,0,1,5,12,2203021.77456815,4774366.37923469
0,23,3,1,2,5,11,2242982.28586056,4744593.69001009
0,34,1,3,0,5,9,2153423.40445524,7230488.19287919
0,10,4,0,2,4,10,2422431.27028556,4964494.49918809
0,33,5,1,0,6,12,2673182.87228017,9299576.15258453
0,11,5,1,1,1,8,2151603.66853424,2427639.73147765
0,14,6,2,0,1,9,1951399.36217392,6689254.07918901
0,30,4,1,1,5,11,2460634.39262059,4723393.73842377
0,13,4,0,1,6,11,1535007.2663025,7482346.60702164
1,36,1,0,2,4,7,1694352.9441138,4162575.87252846
0,28,1,2,0,3,6,1304444.20476401,6122471.28996278
0,12,3,3,1,6,13,2079554.90085726,4203318.51113371
1,40,3,1,0,0,4,1731339.72774332,3032856.59032734
1,33,1,1,1,6,9,1814722.3648384,5996389.92455809
0,23,5,1,2,5,13,2553885.82120003,6010319.94277948
1,16,4,0,2,6,12,2173263.75832738,6144520.2400709
0,14,4,0,1,6,11,2200435.78691628,3385065.26698741
0,31,2,1,1,5,9,1987089.72330496,7161555.59840637
1,27,5,3,1,1,10,1373789.29583472,4942209.70593756
0,24,2,3,0,6,11,1746500.58821431,5343267.1260171
0,40,1,3,2,5,11,2647763.74631398,5259731.07585124
0,17,0,0,1,3,4,1212426.32148148,7903145.5258349
0,27,3,1,0,0,4,1526809.32754613,1338477.20437211
1,13,0,0,1,2,3,1198311.65131462,2717583.96633617
0,29,6,2,2,5,15,2661354.50895336,7941497.29536459
0,27,4,0,2,6,12,1719561.66377223,8881767.62683675
1,24,5,1,0,4,10,1844122.89402376,8198768.33543448
1,15,0,2,1,0,3,1705840.23804502,3175303.10103246
1,18,0,3,2,3,8,2276157.49972119,5665477.115507
0,16,2,3,2,7,14,1860802.71723844,5365870.37036006
0,34,2,3,0,2,7,1978624.36578025,6181702.12341276
0,33,5,0,0,3,8,1767992.10814471,4010450.82788984
0,31,0,2,1,2,5,1510582.19242837,4620606.56735643
0,31,3,2,0,0,5,1582346.77687006,4444766.53133831
1,33,4,0,1,6,11,1867018.00465158,8310087.50593398
0,23,2,0,2,1,5,1684388.33286845,3724295.90485915
1,37,0,3,1,0,4,1502665.1906751,4279741.74100102
1,30,6,2,1,6,15,2685823.23807742,5773890.81342145
0,21,6,0,0,5,11,2314020.50933098,7320624.08604066
1,28,1,0,2,6,9,2078975.22567773,4919257.56292951
1,16,1,1,0,4,6,1358159.88315325,6920825.12253216
0,38,3,1,1,6,11,2139069.05150681,7101993.01542312
0,11,4,2,2,5,13,1202895.62201585,8832869.22662291
1,15,3,1,0,3,7,1100905.54759807,5322377.01773324
0,20,5,3,1,6,15,2356571.78605662,6765700.96454716
1,28,0,0,2,5,7,1648390.66381957,3113423.41129148
1,18,6,3,2,4,15,2945979.67297066,6964161.13510329
0,15,4,2,2,1,9,1903105.2313183,5697291.09434155
0,35,6,0,2,2,10,1494357.17938284,7115041.9311193
0,17,2,2,2,7,13,2126893.75400189,8495144.93314282
0,16,3,1,2,3,9,1637761.32439301,4468409.62293892
0,13,5,3,1,5,14,2054870.24773517,8056940.88308785
0,26,3,0,2,2,7,2179380.96361689,4913480.03109805
1,28,6,0,0,3,9,2467264.90607892,6072906.58223873
0,37,5,3,0,2,10,1849471.99727698,8853239.15127149
0,14,1,0,0,1,2,1151342.46783454,4326420.52897994
0,23,0,1,0,1,2,1069163.52678191,5885134.5590056
1,26,1,2,0,5,8,1743321.93888533,6742513.6847686
0,36,0,3,2,7,12,2503489.46175772,6625639.08836534
1,25,1,2,1,0,4,1133835.62174529,2745739.10403972
0,19,3,1,2,1,7,1481909.29978181,2949665.00401639
0,15,6,1,0,5,12,2115133.67637114,5619962.23218138
0,29,4,2,2,6,14,2232113.46143061,7898866.51091118
1,14,5,2,2,7,16,3029978.39813473,4586317.44880673
0,16,1,1,1,2,5,967379.041983209,6049638.99226526
0,18,3,3,0,1,7,1617490.49334374,5380375.24802264
0,39,2,0,2,6,10,2072356.56489699,5492843.79404389
0,23,4,1,1,1,7,956063.286981437,7202808.43787997
1,32,6,0,1,6,13,2142676.08351377,7321600.19505212
0,12,2,2,0,1,5,1624705.74133518,2716193.41307748
0,39,6,1,1,7,15,2911276.88314125,8586603.4576252
1,19,2,1,1,5,9,1727308.09406336,7066081.31443007
0,29,6,0,1,6,13,2350830.87806644,7844276.35025854
0,29,2,1,2,2,7,1812256.31381651,1988061.86422422
1,39,3,0,1,0,4,1216104.69114575,7086529.67658788
0,10,6,1,0,0,7,1491671.87781963,3908102.87792933
0,20,4,0,1,5,10,2270578.03895124,2912878.12731152
0,27,5,2,2,2,11,2466045.73472852,7553909.83599415
0,19,5,1,1,1,8,1560400.68910557,5518755.21522539
1,25,6,0,0,4,10,1738180.43986895,2960545.12302542
1,16,3,1,2,3,9,1612913.91830712,8166781.80400563
1,34,2,0,2,5,9,1788979.90829055,2866025.35338364
0,38,6,2,1,7,16,2621703.52933224,8382791.13555307
0,26,6,1,2,7,16,2748904.98622854,7583843.18021315
0,23,2,0,2,5,9,2083350.0935667,7948479.20065326
0,23,0,0,0,6,6,1720707.96040065,2810171.86558252
0,28,4,0,0,3,7,1908225.49881474,5452233.59049056
1,38,1,0,2,0,3,1346570.94064059,1681233.61437651
0,25,0,1,0,1,2,1272680.64269351,4661990.95512572
1,25,4,3,1,6,14,1833334.95508799,11633798.7833446
0,16,4,3,0,0,7,1804972.06497893,5443554.00136836
1,13,4,1,1,0,6,1807127.03388966,4720307.75473525
0,37,0,0,1,7,8,1618802.47553353,6085326.54279771
0,20,2,2,1,4,9,1551429.04992794,8048791.31030092
0,14,6,0,2,5,13,2558328.0319192,9243490.5858737
0,15,0,1,2,6,9,1846366.91932534,2656223.08644517
0,12,6,3,1,2,12,2505410.43971378,6509847.9374583
1,36,1,2,2,2,7,2179355.07571637,7050576.30764034
0,37,6,0,0,6,12,1757241.69983608,8050853.88963419
0,33,0,3,0,6,9,2135435.6355063,10867015.7959585
0,22,3,2,0,0,5,1414967.05547536,3542390.32732894
0,21,0,3,1,5,9,2624753.65820924,8863809.09509275
0,21,0,2,0,6,8,1858832.17320249,7341084.76478993
0,35,2,2,1,7,12,2235348.14042248,5948753.38444442
0,27,6,1,1,2,10,1727756.50102759,3674331.75250016
1,28,2,1,2,3,8,1738128.40067265,3186032.86010874
0,28,2,1,1,2,6,1555655.19333328,6834906.678686
0,32,5,2,2,2,11,2376103.4314786,6998697.76075879
1,25,5,3,1,2,11,2519460.26044815,2524907.51200182
0,18,1,1,2,1,5,1640866.84036311,5536562.44202441
0,35,5,1,1,7,14,2776194.24799616,10197642.8722242
0,40,4,3,2,2,11,2409007.40232397,6394847.13373565
0,15,5,0,0,3,8,1555451.60324118,7517552.24104632
0,20,6,0,0,7,13,2658124.09950867,6245377.96916939
1,40,3,2,1,6,12,2970266.81697032,4480269.14877056
0,34,1,3,2,4,10,2019476.14721117,4842923.96827648
0,31,5,2,2,1,10,2443851.40042595,8285360.55478647
0,10,2,3,0,0,5,1271255.37399272,5060932.02003704
0,26,5,1,0,5,11,2140014.58609292,6461748.7450367
1,36,2,3,1,5,11,2045665.0985393,7103813.46125542
0,29,5,3,1,5,14,2588705.76517734,4294636.94970999
0,39,3,1,2,2,8,1983004.8734143,3867887.91322796
0,21,6,2,0,1,9,1788035.2453608,6441452.93540655
0,24,5,2,0,2,9,1790705.98259099,6597766.79965509
1,25,4,0,2,6,12,2025550.88360293,4805104.18206767
1,15,6,2,2,3,13,3137579.48089699,5140185.41250392
0,28,0,2,0,5,7,1711743.97104978,3918454.56552588
0,33,5,1,2,7,15,2149560.18518811,10627211.4377251
0,19,3,2,0,2,7,1805955.33231202,5487459.08556007
1,27,3,2,2,1,8,1431558.37198886,514989.452326493
0,39,0,3,0,7,10,1955151.56447662,4373670.33813679
0,30,0,0,2,3,5,1161873.75578639,3078009.17080517
1,29,2,0,1,4,7,1500709.69863108,7738637.1558302
0,23,0,2,2,7,11,2462671.10129352,8242258.98295172
1,15,3,0,2,5,10,2246206.35333699,7746285.88859868
1,39,2,1,1,2,6,1879851.90624703,5591374.58301553
0,30,3,2,1,6,12,1478344.6988902,7549953.40843018
1,20,0,3,0,5,8,1585469.52641026,7198744.55915751
0,13,4,3,2,2,11,1572153.19734991,7552123.29705134
0,29,6,3,0,2,11,1695878.73941543,6569061.25459201
0,33,4,3,2,1,10,2215272.97773544,5753725.27090032
0,32,3,0,2,4,9,1524702.78933187,4575149.63466577
0,21,3,0,0,3,6,2000832.09981028,3213970.18076834
0,30,1,0,0,0,1,1022399.72582077,3195001.11258581
0,31,6,0,1,5,12,2358303.22404171,2976651.30327589
1,29,6,1,2,3,12,2067833.82865983,8726156.53888058
1,11,4,2,2,7,15,2503961.99616154,7327905.95457468
1,18,2,2,0,1,5,1221076.49125938,5582570.60520673
0,39,0,0,2,7,9,2169676.22272955,7590704.22620557
1,28,3,1,0,4,8,1483513.56614762,5677559.73057141
0,22,3,3,2,5,13,1406830.77488164,6067074.49067005
1,20,0,3,0,2,5,1476866.42168188,6122896.59982936
0,38,6,1,0,6,13,2067894.67739437,6888456.23794033
0,12,1,0,0,1,2,1112708.38098811,3993047.6050206
1,32,1,0,0,3,4,1280158.64818295,7174586.31120822
0,38,5,1,1,6,13,2237492.19572628,9743217.43191997
1,33,2,1,1,1,5,1211307.02918025,4805180.1770069
1,14,2,0,1,5,8,1813273.67263332,3522919.22963437
0,13,2,0,0,5,7,1312709.67734971,3957582.03034163
0,14,0,3,0,2,5,1453723.00479143,5227441.78795408
0,32,0,2,2,3,7,1721461.99380436,7433017.25490409
0,21,6,0,1,5,12,2543456.91209734,9658689.94220878
1,39,0,0,1,2,3,1256486.93390305,4115061.65888966
0,24,6,3,2,4,15,2322002.87913104,9937328.93228132
1,19,4,2,1,0,7,1802245.37231265,4174379.41420232
0,14,2,0,1,7,10,1904846.58865121,7001565.42874588
1,24,0,1,0,1,2,1159255.74566775,4989041.3262587
1,33,4,3,0,5,12,2234327.35769656,8412153.35959403
0,27,4,3,2,7,16,2929701.2930605,11558633.0642348
0,30,6,1,0,7,14,2930976.14478038,6967262.0944763
0,34,4,0,2,0,6,1618075.67335152,4167021.76242956
1,40,4,2,0,0,6,1634993.78236651,4681782.60485824
0,30,2,3,2,0,7,1289929.54917694,6931209.62093176
0,29,3,3,2,3,11,2657733.36067643,7042751.3850845
1,24,6,1,2,1,10,2412667.0460857,5325204.88298144
0,10,2,3,2,0,7,1574985.16746507,2728698.25161457
1,38,1,1,0,3,5,2012795.14977704,5095396.43827245
0,35,2,2,1,3,8,2542767.18880404,3901150.34586944
0,38,5,0,0,3,8,1907244.40022018,6487109.18796911
0,34,1,2,1,5,9,1285025.23115188,4267157.16057094
1,34,1,3,1,6,11,2397658.78607699,3867093.27761938
0,23,2,2,2,6,12,1537761.40635555,5247464.82543181
1,37,6,1,1,7,15,2488009.19885843,8617023.66366038
0,22,2,1,2,4,9,1898288.40120218,5073138.78922731
0,39,4,3,2,4,13,2171233.35118838,7473732.89565999
0,35,6,0,1,2,9,2004349.68017834,6064761.23998627
1,38,2,1,2,7,12,2319393.97067613,7776373.59755336
1,29,5,0,1,2,8,1582757.71231015,6821680.56108025
1,24,0,1,1,7,9,2220108.16536739,6713333.06297859
1,17,6,0,2,6,14,2559610.94566492,7645329.89616401
1,40,0,0,0,7,7,1495920.05069248,6060827.55182112
0,10,6,3,1,6,16,2880402.90228933,9522800.55042033
0,31,5,1,0,6,12,2596011.35819677,5398877.97040388
1,19,0,3,2,4,9,1509945.07874923,7907808.94409578
0,23,1,3,1,1,6,1329185.46642822,2092919.26175884
0,26,5,3,2,1,11,1827339.64971714,11215173.7103363
0,34,4,3,0,0,7,1862889.7980876,7957406.91939926
0,39,6,0,0,2,8,2279964.63981301,6447205.92564083
0,11,6,3,2,6,17,2159892.33491531,7551911.54315394
0,18,5,0,2,5,12,1704080.51161841,5538085.32241459
0,22,4,0,0,0,4,1454539.1478975,3856158.41776315
0,11,0,3,0,7,10,2140940.44413126,6405683.57632771
0,37,0,3,0,2,5,999511.776436344,3664870.82456226
0,18,6,2,2,0,10,2005024.71070639,5156652.89176596
0,20,2,0,1,0,3,1514480.37017953,1514480.37017953
0,26,5,0,0,0,5,1773699.93188421,6457584.470745
0,26,1,3,0,6,10,1877307.36070154,7902373.35818007
1,21,1,1,2,7,11,1548686.083254,8956813.79469137
0,38,1,3,2,0,6,1695254.44462488,5422974.02338116
0,28,2,2,1,2,7,1328446.45656855,4405127.14243312
1,13,6,1,1,6,14,1239963.93801571,6953819.79685573
0,37,6,0,0,3,9,1813236.46656019,2593014.54126012
0,18,5,2,0,6,13,1711251.58865062,8346528.7829721
1,20,1,1,0,1,3,1371028.35148995,4843482.02548882
1,36,6,2,2,3,13,1052368.77451057,8999277.23135088
0,21,1,0,2,4,7,1336381.86025904,3948183.95723583
0,21,5,3,2,4,14,2817275.59423046,7831081.41096922
1,16,2,2,0,1,5,1381559.34090319,2686710.87776386
0,24,0,1,1,7,9,2193808.62545534,626504.331035041
1,16,1,2,1,6,10,1997218.77900862,7292404.394454
0,29,2,1,0,1,4,1521561.44469952,3519693.71636891
0,17,0,0,2,7,9,2246821.50643166,6523414.59891682
1,13,4,1,1,4,10,2294895.26689915,7246657.72712331
0,24,2,2,1,5,10,2118244.17005874,3161712.94207842
0,29,4,3,1,2,10,2151634.61660073,4157351.16403241
0,35,1,0,2,0,3,1455635.43662555,4474595.73555394
1,32,2,3,1,4,10,1541699.41712708,5814997.19480285
0,19,5,1,0,5,11,1793184.07357709,5349189.56343661
0,38,1,1,2,2,6,936619.838484177,5157470.76452968
0,10,3,2,1,0,6,1473253.64792722,7209444.97312786
0,20,3,2,2,4,11,2175576.81012727,9370825.96443773
1,40,6,1,1,7,15,1613079.53525546,3968572.44595027
1,32,2,0,0,2,4,1312473.63293582,5169672.81910123
0,25,4,1,0,2,7,1713890.72144347,3664943.45846531
0,25,6,0,1,6,13,1818650.71422195,6408532.67095971
1,12,1,0,1,1,3,1494803.70119915,5495944.03666184
0,14,6,0,0,7,13,2243672.43867929,9395848.09721342
0,13,4,0,2,5,11,2321155.7038288,3263633.97781831
0,21,0,1,0,4,5,1333735.31711023,6287305.80217795
1,36,4,2,2,4,12,2785010.35784994,6692083.69842679
0,10,5,0,2,1,8,2041673.71502895,4028393.92209083
0,38,6,2,0,3,11,3045716.66007549,4023038.39770785
1,19,4,3,2,4,13,1778015.49130464,4917890.07692732
1,10,3,3,1,0,7,1537953.31407883,3372911.67370816
1,35,0,2,0,6,8,2162795.82049131,5829383.07060784
0,19,3,3,2,4,12,2017342.27692977,6910586.02533062
0,17,4,1,2,6,13,2660639.94885798,7574385.93228467
1,18,0,2,0,0,2,1199458.07471136,430698.387273026
1,27,5,2,2,7,16,2258154.13277999,6476748.78380549
0,38,6,1,2,5,14,2072252.51882406,10936703.0700985
0,31,0,3,1,6,10,1952182.47056488,9470444.16392748
0,11,6,2,1,5,14,2106039.99991003,8034381.81989427
0,34,0,2,0,2,4,1120426.57937052,6897875.80671275
0,32,2,1,1,2,6,1660919.97946636,3562581.66804938
0,30,4,2,1,0,7,1026551.85255431,4411565.35555574
0,12,1,2,0,3,6,1909345.89976498,5348813.76905094
1,12,2,0,0,3,5,1254686.16306338,3040585.00567565
0,39,5,1,1,0,7,1880505.91283858,7896210.60387998
0,12,2,1,0,7,10,1976322.10123636,3963204.90860262
1,36,2,0,1,7,10,1759951.38653617,4482663.29923827
1,22,1,1,2,1,5,2285833.5441759,3328680.73887791
1,26,0,2,2,1,5,1456441.29909353,5520828.97988611
1,19,4,3,2,7,16,2312684.2142167,6693848.3116791
0,37,0,2,2,1,5,1456183.70104322,2483648.31549983
0,11,4,1,2,5,12,1883776.33981426,7264206.69129897
0,35,6,0,0,0,6,1789722.26723583,5362935.0010494
0,15,2,1,1,1,5,1816356.43081212,5466667.98070269
0,23,1,2,1,2,6,1438092.31974756,5119574.87311463
1,35,6,0,1,4,11,2312674.68240166,6882033.61435586
0,27,4,0,0,6,10,1964546.53437896,5604702.02087658
1,37,5,3,1,0,9,1886728.2771472,3718210.7224065
0,29,1,3,2,1,7,1900705.76892362,6982799.37846763
0,38,6,0,2,1,9,1625148.65951152,7412268.14088961
0,10,1,2,2,3,8,1497078.12349701,4276507.32193632
1,16,2,1,0,4,7,1763959.24850755,6693876.60157112
1,21,5,3,1,6,15,2549501.89849516,9352729.29483536
0,29,5,1,2,6,14,2562313.37633581,6584557.83271637
0,18,0,0,0,3,3,1254738.25076616,4425492.23477117
1,39,1,3,2,1,7,1373021.53760871,4746773.76315594
1,38,5,1,2,7,15,2257884.53479866,9847504.86275977
0,31,5,3,0,4,12,1772337.64680391,7172511.84821013
0,21,1,3,0,7,11,2105334.15767478,8897682.18226033
0,18,6,0,2,6,14,2465598.34360558,2916694.37421733
0,20,2,3,1,1,7,1874173.17309991,5287050.81376861
1,24,4,3,1,2,10,1745627.46517237,6237950.26614893
1,14,6,2,0,4,12,2791249.4081709,5754218.24228006
1,17,2,2,1,7,12,2483257.60963113,8884252.1520365
1,36,2,3,1,6,12,2972391.86689885,5615885.48403083
0,10,4,1,0,5,10,2106993.73212427,8250801.44018861
0,27,1,2,2,6,11,2482802.96755255,6225992.36059871
1,10,4,2,1,3,10,2271166.05259471,7398261.11708266
0,39,3,1,2,3,9,1561823.7255719,4460514.24620917
0,14,3,3,2,1,9,1717645.14638251,6774078.54630872
0,27,5,1,2,6,14,2621782.70085264,8323260.7166928
1,27,0,2,2,2,6,1381628.14820321,8099930.93349
0,29,1,2,0,0,3,1371523.11607159,2892740.11759306
0,13,1,0,2,0,3,1741051.99598702,1741051.99598702
0,26,5,2,1,4,12,2256448.88291695,7776439.18912782
0,10,3,1,2,2,8,1816528.02652541,5000336.17092308
0,16,0,3,1,5,9,1726943.06253833,6249011.97822723
0,37,3,2,0,3,8,1590402.48439034,5437783.1608866
0,30,2,1,1,5,9,2424442.18314545,5870334.16592275
1,40,2,0,2,2,6,1633677.67077769,5122691.54911683
0,23,5,0,0,0,5,1427806.99036564,2441333.37140854
0,40,5,1,1,2,9,1703339.47315483,3340609.17576806
0,18,1,0,2,7,10,2061825.3065736,4993668.04965057
0,33,2,2,0,5,9,1314269.19377559,5699968.35194714
0,40,2,0,1,6,9,2307805.50538579,9154240.08068139
1,11,6,1,1,7,15,2323269.44535351,11181578.1070874
1,24,1,2,1,3,7,1736156.54340147,5899638.00392937
0,37,0,3,1,1,5,1316498.40748516,7608073.06867669
1,18,0,0,0,3,3,1292240.54148103,2401322.43761583
1,26,4,2,2,2,10,2681313.29227859,7086347.47648893
1,14,3,3,0,2,8,1903180.38391169,7125333.31099979
0,15,3,0,2,7,12,1827106.47136254,4996231.88618049
0,32,2,3,2,5,12,2703615.78739573,4685991.88054363
0,24,1,1,1,2,5,1457484.83470151,2866718.02132815
1,16,5,1,2,1,9,1855961.57662459,7347636.59934661
0,35,4,1,0,3,8,1943364.63664214,6115755.81120208
1,30,3,2,0,1,6,1288152.79020363,2194789.65373577
0,27,0,0,2,2,4,1488718.44727297,3260973.12698145
0,20,5,2,2,3,12,2747264.72136198,8552484.43139361
0,35,3,2,0,3,8,1943885.5453147,5848304.36494019
0,29,1,2,0,4,7,1575085.13566347,6052094.53017892
0,13,6,2,2,4,14,1844486.10978042,8114095.17128569
1,36,3,3,2,7,15,2570467.68055473,9658334.79598003
0,11,6,1,0,6,13,2068024.15240168,7016502.75866623
0,17,5,3,2,0,10,2350574.66160945,6559514.28220323
0,26,3,2,0,6,11,2120647.20700969,7657048.32906896
0,32,6,0,1,4,11,2003513.50039879,6074766.70106224
0,31,5,3,2,6,16,3488679.66421451,9702160.38153412
1,40,4,2,2,1,9,1597539.0786446,3104937.63647603
1,26,3,2,1,6,12,2467539.2804003,7216524.15670066
1,27,3,2,0,3,8,1774755.65939483,7504151.09890199
0,31,4,3,0,7,14,2123317.26543374,6746749.29496951
0,36,4,3,1,1,9,1791195.39900364,4513177.37864695
1,11,4,3,0,5,12,2475685.01519718,7226547.14546551
0,38,5,3,1,3,12,1927819.80497846,7937461.17253402
0,39,3,3,1,3,10,1859202.99095358,5074892.83919674
1,27,5,3,0,0,8,1582548.95125023,5280015.76466687
0,31,0,2,2,6,10,2050538.33515964,8317533.42688812
0,17,4,3,0,6,13,1843742.68270823,10534766.1359885
0,33,2,3,2,2,9,2076410.8833585,9505411.60594706
1,28,5,1,2,0,8,1690642.89505607,4873507.35825759
0,13,3,1,0,4,8,1656277.22422997,7499740.82616313
1,27,4,2,1,4,11,1949160.79967747,4219528.04466876
0,10,6,0,1,2,9,1346210.03040793,5016339.41768267
0,14,6,3,1,0,10,1836684.8568343,8520638.53564495
1,27,1,1,0,0,2,1180564.27832392,4214904.57584423
0,19,2,3,2,2,9,1864307.80863019,6135311.38535781
0,23,3,1,2,5,11,1821601.8056695,5870043.17658113
0,12,4,1,2,6,13,2509991.57992953,5158625.25347739
0,25,1,3,1,1,6,2162631.48885705,8663273.56672109
1,19,0,2,0,7,9,2027153.49306706,7244488.2549358
0,30,4,0,2,6,12,1664423.0263435,1895293.92879761
0,27,2,0,0,4,6,1264573.60367772,5419596.20950659
0,13,4,3,1,4,12,2032953.19963986,6928768.29189855
0,14,3,1,2,0,6,1452292.39128025,3106266.11115956
0,38,1,0,1,1,3,1706326.25806225,3290658.77032621
0,27,2,1,1,5,9,2183444.90244818,3046794.50770314
1,10,2,3,2,3,10,2265549.25597873,3812831.54741681
1,39,1,0,0,4,5,1500513.19086091,773562.956884335
0,38,2,0,1,3,6,1491851.25310828,3299784.81506495
0,18,6,0,0,6,12,2835711.22011694,7334103.58996467
1,21,5,3,1,1,10,1966979.28730641,7503270.52324928
0,40,5,3,0,3,11,1961322.28500465,6900593.50155849
0,11,2,0,0,2,4,1681011.02478391,6822052.37363185
0,35,3,3,0,6,12,1739107.90056207,10111174.3472975
0,32,2,3,0,5,10,2183608.83634732,6614947.03867725
1,24,0,1,1,2,4,1608443.96658752,803836.007229051
0,10,4,1,1,3,9,1962997.51688894,6642290.38370914
0,32,3,1,1,7,12,1826325.47590582,3433640.75931279
0,36,3,0,2,2,7,827034.408807863,5945164.06102828
0,23,6,1,0,1,8,1506888.95598942,3700878.66500736
0,16,5,0,1,2,8,1850700.43232155,6059931.87141653
0,11,5,0,2,1,8,1487132.27271064,5030052.22257347
0,13,2,1,1,6,10,2003904.1195914,8349799.09219621
0,16,1,1,2,7,11,2590224.44906881,5646248.79912065
0,11,3,0,1,6,10,2101432.66275042,5050676.7600793
0,10,6,2,0,0,8,1501169.92933856,4169094.63633666
1,19,4,1,2,1,8,1486302.25032791,7957094.66621525
0,12,6,3,0,4,13,1956572.42308296,7653550.26980825
1,13,3,3,1,7,14,2507036.97036844,9886640.7860181
0,15,6,0,1,0,7,1639104.27678861,4816319.78467055
0,35,4,1,1,2,8,1663026.09898352,5966263.56224672
0,29,5,0,0,0,5,1282523.41558255,4270855.96063671
1,29,4,1,2,2,9,1954137.89860488,4489440.90043526
1,28,1,0,1,5,7,1442581.24067483,7262358.35516683
0,23,0,3,2,6,11,2542367.98807153,5804233.66621311
1,22,6,2,0,4,12,1797750.17140972,6260597.94982447
1,12,4,1,1,4,10,1695893.86444682,3093088.16712813
0,11,0,2,1,5,8,2366371.05449902,5782058.52130665
0,39,2,3,0,7,12,2616465.59626058,7856216.85999316
0,32,5,3,2,7,17,2398819.79319104,9303431.03386058
0,25,6,2,1,6,15,2436160.49124768,8070021.74060165
0,28,3,1,1,4,9,1655905.35465435,5294002.89197625
0,40,0,1,1,6,8,1994169.41724946,4695893.72254333
0,25,0,3,2,4,9,2051156.49099972,6899591.73430063
1,18,1,2,0,2,5,1072861.84726405,5100521.4549125
1,37,5,3,2,3,13,2238356.53761489,10035361.4149734
0,39,6,2,2,6,16,2787939.76240202,9827670.32414524
0,22,3,0,1,4,8,1379579.42716145,5908174.34318247
0,27,4,0,2,1,7,2022500.35934985,7550819.78236485
1,36,5,2,0,5,12,2467324.26462303,8372906.71673914
1,34,1,1,2,4,8,1787586.64988592,4555306.08853869
0,29,5,1,2,5,13,2127361.32386459,9333010.59565623
0,16,2,2,1,7,12,2432098.56956454,6776641.4790952
0,15,6,3,1,4,14,2350680.18201549,9804082.13799496
0,19,0,1,1,4,6,1485766.62045288,3283885.13523552
1,10,4,3,2,1,10,2059767.8134915,6397598.55803911
1,39,0,3,0,1,4,1317507.6261791,4309248.46708322
1,33,5,1,0,3,9,1637969.08607134,2906433.54734514
0,14,5,1,0,6,12,2166325.29893399,7615160.22419459
1,37,0,1,2,6,9,1897910.66103823,7394249.29602169
0,10,3,0,1,0,4,1566090.4346667,5240683.57253371
1,22,1,0,2,6,9,2033176.34830766,4720758.35903222
1,17,4,3,2,0,9,1791739.9875504,5772827.09844393
0,25,4,2,1,5,12,2424235.12307784,8293999.51947443
0,33,2,0,2,7,11,2452059.48243871,4366872.73934977
1,11,5,1,2,3,11,2717864.90949181,4083406.48610288
1,17,4,2,1,2,9,2456932.64544705,6327361.19045942
0,22,1,1,2,5,9,1900716.51910789,6871503.91477538
1,11,3,1,1,4,9,2033387.06154158,6531421.58135669
1,19,2,2,2,4,10,2107281.88516768,8242107.83238299
0,23,1,1,0,4,6,1843986.31568956,4549129.67523233
0,21,1,2,0,2,5,1378671.38144144,3793348.44670938
0,20,5,3,0,2,10,1694242.67588214,7671364.41386818
0,40,4,0,0,3,7,1199641.38469145,4874931.95357935
0,21,3,3,1,5,12,2014075.51430599,8708335.92958736
0,13,4,2,1,3,10,2086453.73730739,7547409.49906238
0,40,5,1,2,3,11,2305978.36600893,5465331.49177689
0,33,3,1,1,0,5,1578300.82447192,2887232.10483465
0,31,4,3,2,6,15,3039954.83689765,8982156.81467093
0,21,6,0,1,5,12,2413504.91766537,5471848.34031563
0,10,4,0,1,7,12,1702851.61254914,6001212.50200744
1,23,1,2,1,4,8,1154131.597251,5493203.37638159
0,28,5,2,1,7,15,2123210.48350511,6049760.34998232
1,29,0,1,1,5,7,1581544.78941178,5496848.85779314
0,18,2,3,1,3,9,1537484.90408028,4559220.2818901
0,19,5,3,1,2,11,2042027.1082204,6357643.80042867
1,38,6,2,0,5,13,2869800.35440701,3551456.25581375
0,14,3,1,2,3,9,1296488.50828505,3962465.70165932
1,17,0,3,2,5,10,2055692.3328134,6673459.01875266
1,30,3,0,2,5,10,2021228.37698192,6660741.68953019
0,28,3,0,2,3,8,1647455.08326232,5042957.557572
0,14,3,2,2,5,12,2932030.20825283,5460740.70170853
0,32,1,2,1,6,10,2285545.66441762,2523439.15442262
0,36,5,0,2,6,13,2124056.35212262,5522401.30099541
1,31,1,0,0,5,6,1617316.44259287,2047384.94871145
1,33,5,1,1,1,8,1714417.80328792,6349608.67860967
0,20,4,3,2,1,10,1783547.52443308,6987466.09316282
1,25,0,3,0,5,8,2001368.19583779,5527829.21467539
0,12,2,2,2,1,7,2126273.31904408,4792410.73606847
0,27,1,0,0,7,8,2363046.03956062,5443461.76044667
0,21,1,2,0,5,8,1735250.69748952,6338668.47110084
1,13,3,1,2,3,9,1546519.62032748,7789681.14679299
0,34,0,2,0,6,8,2177839.34629992,4946268.79838204
1,18,1,0,0,2,3,1048781.5310589,4741771.24280511
0,37,5,0,1,3,9,2154884.36354527,4787146.42810978
0,22,3,1,0,1,5,1464268.34943387,3989334.77881217
0,27,0,3,0,0,3,1161680.85531541,3716237.35127049
1,16,2,1,0,5,8,2164837.36757934,7729010.28762376
1,35,4,1,0,7,12,2452503.84550857,7988792.09422349
0,29,3,1,2,1,7,2092893.91840681,6154283.87046313
1,29,2,0,0,7,9,2041542.69294371,2292775.1399708
1,16,3,0,1,4,8,1815153.10548798,4949023.85681254
0,32,3,1,2,1,7,2060214.95561908,5550575.63478799
0,20,1,0,0,4,5,1412646.00889115,5828097.99996908
0,27,1,0,0,1,2,1329160.70090507,3235211.20186075
0,15,4,0,0,4,8,1748608.516445,2381427.30313968
0,35,4,1,1,1,7,1158215.34300956,6005218.147954
1,21,6,3,2,5,16,2496704.19317362,9098994.80989772
1,30,2,1,2,5,10,1978861.81364889,6608947.45649453
0,10,0,0,2,1,3,1198919.88546598,1420827.9612846
0,37,3,0,0,3,6,1734823.42807454,4939624.63830283
0,40,1,1,2,2,6,1671858.5290132,5420137.81933463
0,39,6,0,1,0,7,2146031.37373642,5480243.50261832
1,36,5,2,0,5,12,2491524.62371899,2224119.21098577
0,26,2,2,1,5,10,1874310.6826885,4700130.37045944
1,11,3,1,0,5,9,1641099.13841965,6039381.12152598
1,22,4,0,0,2,6,1989341.47681591,6309108.10287731
0,10,5,2,1,6,14,1987216.27116878,5662835.44360039
0,25,0,2,1,6,9,1706415.25054397,6883044.32932864
1,29,4,3,2,5,14,2342658.72020441,5192556.53594837
0,27,5,1,0,5,11,2334742.45005344,6878368.15183589
0,16,1,3,1,5,10,2590560.26699302,5214451.9273308
0,37,4,1,2,2,9,2446859.43676935,6777269.33443847
1,22,6,3,2,6,17,2379440.60136619,7551782.78535275
0,15,2,3,1,4,10,1646828.84875844,4496882.7668481
1,16,0,0,1,6,7,1602615.09700563,2136842.4177435
0,21,5,1,1,2,9,1989075.81664987,8263801.15696036
0,33,0,0,0,5,5,1499210.19391878,2358438.66150365
0,25,6,2,0,2,10,1441501.9111456,10032878.2125693
1,20,5,1,2,6,14,2500174.23275314,7454366.21785384
0,16,0,2,2,3,7,1874201.27149161,4076918.62133012
1,28,5,0,1,6,12,2171319.85727998,8641767.17928999
0,21,0,2,1,3,6,1519807.67782805,3493373.60253042
0,15,4,0,2,6,12,1790188.64488097,6649426.73101421
0,36,2,2,2,1,7,1611237.85787209,5680178.14096004
0,22,2,3,0,2,7,1422126.88305226,6427722.82864247
0,11,2,3,1,3,9,1640560.31885926,3609336.88730863
1,30,3,0,2,3,8,1941260.63943191,4851302.62821875
0,24,5,1,2,0,8,2004407.31229303,4067836.16220275
0,36,2,3,2,6,13,1997461.18587698,7320613.92044292
0,32,4,1,0,7,12,2068558.14842784,10307191.7071696
0,15,0,0,1,1,2,1279094.01789417,4108200.36328597
0,16,5,0,1,1,7,2530760.1126402,5920480.67287527
0,21,4,3,1,5,13,1796140.05057588,7501725.111063
1,27,1,2,2,1,6,1542695.75700139,5510511.857569
0,26,1,2,1,6,10,2102993.93058891,2923356.57747295
1,17,3,1,0,1,5,1139488.61852856,6322961.51810216
1,29,0,2,2,2,6,1284304.44813857,2882812.96014786
0,33,5,3,2,3,13,2833610.08272189,9810170.64568252
0,38,3,2,2,5,12,3012902.30589251,7360427.57359941
0,11,5,1,1,0,7,1434837.90513354,4230951.20341375
1,22,1,2,2,6,11,1910394.80573109,7928136.20324596
0,13,5,2,0,2,9,1835649.72082846,6427551.63669181
0,14,3,0,0,2,5,1398406.89523584,3689852.9124145
0,38,4,2,1,3,10,2474267.17581523,6496504.5325422
0,11,6,1,1,7,15,2095006.45278657,2102914.48721289
1,31,1,1,2,0,4,1154528.74690857,3966377.7586019
1,16,6,0,1,0,7,2123955.90615405,6946684.88371295
1,18,1,0,2,4,7,1362364.3003765,7117811.14040024
1,13,3,0,1,0,4,1221326.42675751,3890525.88176652
0,13,4,3,2,7,16,1993134.9792882,6766716.44280924
0,39,3,2,0,2,7,1938504.21590243,6219096.16444992
1,16,0,3,1,6,10,1879704.78012781,9671333.28457246
0,19,6,2,0,1,9,2046329.45212462,6627546.32456949
1,36,3,1,0,5,9,1802093.5896803,4597581.23752393
1,27,4,0,0,2,6,1045213.20029067,4091634.04611376
1,22,5,0,2,5,12,1814746.70269299,3747066.13832838
0,22,3,2,2,5,12,2118398.29204035,7942599.2527228
0,10,4,1,0,3,8,1359433.94735194,6034919.72753138
0,15,3,2,1,6,12,1594036.16370999,5809685.74958024
0,39,6,0,1,5,12,1879300.70583486,9984740.03976207
0,25,5,1,1,3,10,1861401.27545434,6184666.65050637
0,40,1,2,1,4,8,1680899.28480624,5847064.33098499
0,14,1,2,2,3,8,2313253.69682713,4514790.61101378
1,24,1,1,0,1,3,1332278.88668836,3908519.86595703
0,34,6,2,2,5,15,2526393.67035372,4382646.60688947
0,11,2,2,2,2,8,1843450.99178998,6402485.25299618
0,12,5,0,0,2,7,1518895.09882768,9571283.93433955
0,26,2,1,1,6,10,1928038.64097204,9155874.62500891
0,17,3,0,1,0,4,1405010.17157259,2696418.70182711
0,25,3,1,2,5,11,1516172.38644963,5511549.34862874
0,11,4,2,0,1,7,1616740.81428832,5432595.28793729
0,33,6,0,1,3,10,1534131.10566971,7102846.4336419
1,40,4,1,0,6,11,2049169.65002144,8155767.43466188
1,38,1,3,1,7,12,2892697.44749259,5159481.3354683
0,33,6,3,0,3,12,1903587.59640146,8448857.84698961
1,21,3,2,1,0,6,1708282.14411915,7351324.11766388
1,30,6,2,1,0,9,1748924.86002307,5299592.81753568
1,18,6,2,0,0,8,1871187.34952055,6156401.94454649
0,23,4,2,2,1,9,2152545.09627184,2423361.36061115
0,35,2,2,0,5,9,1610559.48708166,5555642.95960691
0,15,1,2,0,1,4,1348146.03106588,1845929.7699954
0,27,4,2,2,0,8,1708225.86407771,5220884.77249019
0,12,3,2,1,3,9,1814994.23190605,5138668.16147398
1,35,1,2,1,1,5,1606304.73574895,4755602.66749932
1,17,2,3,2,3,10,1801848.91314442,4047053.48957763
0,20,5,2,1,4,12,1787626.96623188,7747170.71647969
0,22,2,0,0,3,5,1837603.33347658,3833245.44758327
0,15,5,3,2,2,12,2005984.20965293,7514730.56077168
0,18,2,1,2,5,10,2274377.09109506,7200601.94847387
1,31,0,1,0,7,8,1780970.42363982,4328543.24396227
0,13,4,0,0,6,10,2068369.74771915,4117273.72804674
0,22,4,3,2,3,12,2089975.74562681,4208153.05165624
1,23,3,3,1,6,13,1880161.26441158,6410187.84744682
1,10,0,0,0,1,1,1136632.03743224,3012672.50013277
0,10,4,1,1,2,8,1412696.27256834,6197280.0354005
0,24,1,2,0,2,5,1288993.96546112,5698424.35726755
1,32,3,3,1,0,7,1548710.08037294,3791973.17112889
0,34,2,3,1,5,11,2251097.28515212,8162291.61180413
0,15,2,3,2,6,13,2605997.76937368,6371098.67447757
1,23,3,1,2,3,9,2017899.29524126,3100309.01861011
0,11,3,2,0,5,10,1487706.27397439,6301987.99427784
0,34,0,1,2,1,4,1261797.58545154,4387971.97095898
0,34,5,1,0,4,10,2466496.70790178,9056897.63714113
0,30,2,0,2,4,8,1393366.57828432,5229065.52555932
0,13,3,0,1,0,4,1460633.40147151,5176548.12780847
0,23,2,3,0,7,12,2263547.09047776,2615734.84849377
0,12,0,3,1,3,7,1755362.83913107,2055259.39500422
0,27,3,2,2,7,14,2132966.83345274,9675266.05007342
1,38,0,1,2,5,8,1795384.26646196,5549539.62986717
1,15,5,0,1,2,8,1856961.06144664,3359035.13820038
0,15,1,3,0,0,4,1398257.80983191,6945442.26318857
1,37,6,2,2,6,16,2464582.20023277,5756465.46434065
0,39,1,2,1,5,9,1942272.19450161,5800182.08622534
0,37,5,1,2,3,11,2685361.85538663,7760109.91184003
0,15,0,2,0,5,7,1746812.94845109,4427293.15343683
0,39,1,0,0,3,4,1775089.75295496,4526771.67934554
0,29,2,0,1,1,4,1490845.85010779,4735600.83776308
0,13,1,0,1,3,5,1400408.25057557,4050617.99589384
0,27,6,3,2,0,11,2175192.80059444,9875511.31434451
0,30,3,3,1,1,8,1764982.70873302,5741216.87284814
0,16,5,1,1,4,11,2681114.16934433,2912497.03458126
1,33,6,3,1,7,17,2880160.0685729,8260885.56557025
0,10,3,0,0,7,10,2202562.68319941,7595117.5990819
0,20,5,1,2,6,14,2769945.73736065,14590516.0024302
1,21,1,3,0,3,7,1652803.97945508,3138701.00545633
1,26,5,0,2,5,12,2765805.51289398,7639525.42777127
1,33,2,1,0,1,4,1280801.78175609,5242884.11959076
0,29,0,3,2,4,9,1865057.053413,6204483.3969921
0,11,5,1,1,2,9,1333770.98914884,6510091.92477318
0,20,3,3,2,0,8,1743919.39077937,5469963.97900361
0,36,6,1,0,0,7,1511884.43060767,5389929.82308846
0,30,6,0,1,3,10,1716002.62768387,4797965.5387575
1,22,6,0,2,0,8,2343961.87259949,3397552.76339391
0,21,1,3,0,6,10,1572970.7533369,2969257.62237193
0,40,6,3,2,1,12,2571712.8317885,9722143.71523578
0,39,0,1,2,6,9,1792365.11692922,4973961.18294036
0,15,4,3,1,1,9,1893177.80400809,5195022.54381974
1,40,6,2,2,1,11,2029000.49089777,7502891.22672932
1,33,6,2,1,7,16,2845466.99223948,9187104.3173278
0,24,3,0,2,3,8,1888099.67805212,5982382.14797227
1,29,0,0,2,2,4,1100321.74444412,3634249.68367224
0,31,4,3,0,0,7,1476882.69160575,916949.577880102
0,13,4,3,2,0,9,2328552.76293321,5677004.79819384
0,39,3,0,1,4,8,1760952.02029853,3439534.79693447
1,35,4,2,2,3,11,2128721.18000455,5894239.38322656
0,24,2,0,1,4,7,1950297.95164456,4494730.00115241
1,25,3,0,0,2,5,1586895.47724078,6762965.41782319
0,23,4,1,0,2,7,1621104.54170135,5915489.06015711
0,34,5,0,1,3,9,1817475.04506441,5232227.26903339
0,24,4,3,0,0,7,1704529.8482513,5504194.6537302
0,36,2,2,0,6,10,1394825.76759,8693167.32636001
1,19,6,2,2,0,10,1424285.50687178,7948707.79659056
0,11,6,2,2,6,16,3015910.35449066,7925484.59729546
0,12,0,3,2,7,12,2474357.76379456,4969770.37593336
0,38,3,2,2,6,13,2670046.84024914,4205983.87665281
1,25,0,0,1,1,2,1008630.0790443,268481.798839232
0,25,2,1,0,0,3,987630.171908743,2144217.4243475
0,30,5,2,1,4,12,2213606.04096893,6598878.61214462
0,13,0,3,2,0,5,1453719.72170076,5238395.8894598
0,20,1,0,2,7,10,1524826.80504597,5149963.19119162
0,14,1,1,1,2,5,1364004.92871777,5500577.79277232
1,13,1,0,0,7,8,1208894.41472611,5387285.3511935
0,23,3,0,2,0,5,1753745.68428566,5556730.37501609
0,23,2,2,1,1,6,1487290.86096824,3894864.6017016
0,28,2,0,1,1,4,1331637.50816679,3256744.74333379
0,32,3,2,2,7,14,2498313.23981072,6710796.72790942
0,13,6,1,1,5,13,2348578.0223172,7260201.22448568
1,39,0,3,0,7,10,2031047.68253064,6950051.7160205
0,25,4,3,2,5,14,3319537.05565109,6023513.93897601
0,19,0,0,1,7,8,2518505.17150911,6045336.85534005
1,38,4,2,2,1,9,1999499.25285831,1313987.62741649
0,24,2,1,2,4,9,1843160.18509091,7836845.64146711
1,26,4,2,0,4,10,1941689.72911819,6841600.72823362
0,38,0,1,1,6,8,2131824.91674508,3945767.04565735
0,10,5,1,2,3,11,2096994.77450284,4383540.65535296
0,12,1,3,0,5,9,2016693.61205568,4880999.42457404
1,27,4,0,0,7,11,1924210.0020538,7703251.67996647
1,18,4,0,0,1,5,1907886.95678793,2543970.04690438
0,19,2,2,0,1,5,1962792.66492662,4649238.79972293
0,36,3,3,0,1,7,1397227.86869226,8465427.85216308
1,19,3,2,0,2,7,1345441.71014731,4249570.42943686
0,40,5,3,0,2,10,2214529.04663195,4350215.07580847
0,17,1,1,2,7,11,1863692.29590515,5546752.73969576
0,28,0,0,1,6,7,2113651.30338065,3386286.19992572
1,20,6,3,2,2,13,2264520.55575233,5154681.38410434
0,11,1,1,0,7,9,1928713.71759546,5383749.04679074
0,19,2,3,2,1,8,1521804.63467877,6495790.73292831
0,27,3,1,0,4,8,2149736.22885818,4720441.32065326
0,24,6,1,0,6,13,2208357.32690288,8449645.84990852
0,27,3,3,1,4,11,2082592.66444879,5629475.2027177
1,39,3,2,2,2,9,1695132.85479755,8351044.63761736
1,25,1,2,0,3,6,1428472.23068732,4919793.96642422
0,38,3,1,2,5,11,2589312.21678597,3320864.6378914
0,28,2,2,1,4,9,1958743.13418188,5935120.65861838
0,11,4,2,0,7,13,2726982.460846,8255096.65066945
0,20,5,2,2,4,13,2927652.46211923,5148841.84482759
1,15,0,2,0,3,5,1559702.58919979,900654.432279425
0,37,1,2,0,1,4,1519472.74814879,7965999.91930704
1,17,0,3,2,1,6,1115148.06003162,5059135.20149277
0,23,0,1,1,4,6,1239729.55197308,4350340.09433703
0,12,5,0,0,1,6,1691445.03752073,2907582.30946715
0,29,5,3,1,2,11,1739171.82554488,5491904.48279625
0,36,6,2,2,2,12,2447556.13330817,8084697.12864072
0,20,5,0,1,3,9,2403221.87347004,2690841.4909545
0,11,2,0,1,1,4,1425329.24930492,5165361.78452322
0,12,1,2,2,1,6,2014272.08044582,3950985.80864835
0,35,2,1,1,0,4,1582252.79290119,4112758.63051378
0,21,1,1,0,3,5,1212411.39329754,3835456.68135283
1,16,1,3,2,5,11,1616738.91606961,7431350.2563596
0,29,0,2,1,1,4,1389033.39977513,2124767.76344261
0,36,3,3,0,7,13,1687999.65126324,8208897.33803256
0,21,6,1,2,7,16,2713195.9661651,9159999.30652118
0,10,5,2,2,2,11,2387791.21181292,8076505.26383392
0,29,6,2,1,2,11,2389209.16517048,5476471.30690746
0,16,2,3,2,6,13,2371562.2198851,3523188.14345151
1,28,4,3,2,5,14,1979506.74779711,7361440.55615922
0,14,0,2,2,4,8,1586812.48564271,6530831.55341388
0,28,1,2,0,0,3,1168008.01188676,3888156.07665676
0,25,3,0,0,6,9,1942154.65700294,5365561.36771557
0,25,5,3,2,5,15,2198631.42547634,7727640.29559418
0,20,4,0,2,7,13,2248669.04171114,7250642.08717861
1,17,3,1,2,1,7,1442922.5184341,7040747.32571943
0,12,3,1,1,2,7,1713120.10475547,5792037.63526943
1,17,4,1,1,6,12,2850254.46685249,1486365.28931154
0,24,1,2,0,5,8,1172709.54636143,6887558.29617869
0,28,1,0,2,6,9,1915429.48004043,8685652.74402536
1,28,1,2,2,4,9,1177023.9419781,4673338.6451148
0,33,1,1,2,6,10,1679888.53543873,222138.81604758
1,20,2,0,0,4,6,1622412.66483939,4680486.68927997
1,35,4,2,2,4,12,2476164.74826515,7077311.54879809
0,13,3,0,0,0,3,1368050.37080141,1439304.32305374
0,21,4,3,0,3,10,1808174.14267072,8145796.86102135
1,17,6,3,1,4,14,2552832.16271425,3937567.89780069
0,36,6,1,2,4,13,2690234.53184461,6624027.1368118
0,25,4,0,0,3,7,1447808.9864922,5384128.42533663
1,40,5,3,0,1,9,1979046.30868031,7070386.12190337
0,10,3,0,2,1,6,1190304.23205217,4347986.83947072
0,18,3,2,0,5,10,2139318.06105227,6946370.94374374
0,18,2,3,1,4,10,1895247.82329854,5990269.11647658
1,13,6,0,0,2,8,1606663.08410106,4882035.10131447
0,37,1,3,1,7,12,2095608.28330234,6009370.51421446
0,28,2,1,1,3,7,1661997.58669837,5126889.66602321
0,12,0,0,2,4,6,2035163.06505454,4899309.15099001
0,35,4,2,1,4,11,2169296.69718723,6532373.14050821
1,37,4,2,0,2,8,1577632.00814315,3266223.21711898
0,32,4,0,1,6,11,1967067.96412553,6640512.40061579
0,27,2,0,1,1,4,1550972.05221105,6554166.79544789
1,11,0,2,1,4,7,1588032.38855684,4883730.54211861
0,38,0,1,1,3,5,1348917.78011544,4741927.10739459
1,34,4,1,2,7,14,2443051.04459121,5366079.37886537
1,10,1,0,1,4,6,1384610.1823983,5390174.32986657
0,33,2,3,2,6,13,2335618.87240828,6924429.20523348
0,19,3,0,2,4,9,1888233.17186242,7179453.64968134
0,33,5,0,2,1,8,2211347.41157752,4915687.54525971
0,21,1,0,2,3,6,1811214.90926522,4478577.95328122
1,12,1,3,0,5,9,2297660.69269843,6498148.86362614
0,25,4,2,0,4,10,1914613.33837754,6856931.64990622
1,29,3,1,1,6,11,2067152.46898136,5892384.29887353
1,30,0,3,2,4,9,2036686.85720105,9514897.32572309
0,19,2,1,1,4,8,1893152.8376379,5377439.00557516
1,24,5,1,0,0,6,1977088.07323286,6280617.0578616
0,40,1,3,0,4,8,1380164.15772652,4899067.4980096
0,17,3,0,0,6,9,2279273.09784091,3266136.35314312
0,13,5,2,1,4,12,1383200.89201183,7794836.95436187
0,18,4,1,0,4,9,1506932.40625688,6631886.66284999
0,18,3,3,0,3,9,1967282.75772165,5898411.69429313
0,37,6,0,2,6,14,2675329.30201355,6398084.93304128
0,25,3,1,0,4,8,1655498.95967551,4317001.05795679
0,11,6,3,2,2,13,1671685.69977517,4661543.73128469
0,20,1,2,2,6,11,1759447.93912933,5977878.88963251
0,27,0,2,2,5,9,1950051.51112239,8145303.67002632
0,11,2,0,0,6,8,1321001.81866578,4953533.93194098
0,32,2,3,2,0,7,1708305.80991143,6133807.85047552
1,22,2,0,0,2,4,1535712.22121557,4215801.02405431
0,30,6,2,0,1,9,1683872.89959163,3109815.67605897
0,37,0,3,1,6,10,2159707.13987042,4716612.29663637
0,18,3,1,1,7,12,1924292.07904144,6569035.84962595
0,33,6,2,1,3,12,2209424.73054768,6901727.54692824
0,30,4,3,0,2,9,2009320.94004661,6451695.23413047
0,32,1,1,2,5,9,1906889.85361452,5494249.10210439
1,38,1,2,0,3,6,1918282.51723737,5424720.5612584
1,34,3,1,2,7,13,1844020.18992908,4650234.42572455
0,36,0,2,0,0,2,1311213.95925936,3911978.66326704
0,11,4,0,2,6,12,2670172.24889946,6834877.27005498
0,14,6,0,1,6,13,2272461.35242399,5020657.5830077
0,14,2,0,1,7,10,1984249.92188734,5368070.45709704
0,11,0,2,2,4,8,1731664.74062972,5067152.64351933
0,11,0,1,0,1,2,874897.984794678,2381946.19564059
0,11,1,2,0,2,5,1292078.11563434,2731160.20103395
0,20,6,1,0,6,13,2400763.29990166,7955545.78730708
0,33,2,1,1,3,7,1548940.27489478,3927770.86759962
0,34,5,1,1,0,7,1984983.06210633,5688731.71397775
1,11,0,3,0,5,8,1984237.24768416,4165276.23383426
0,20,5,0,0,3,8,2121484.65282838,4438765.09804131
0,34,4,0,0,5,9,1869550.76979842,4690559.60907387
0,24,0,2,2,4,8,1757625.25304755,5251885.93342846
1,23,1,1,0,1,3,1398934.53650355,5435581.72705506
1,38,1,3,2,3,9,1895918.76996794,6292914.09626453
0,39,6,0,2,2,10,2082277.95342432,2905291.09912478
1,24,3,0,2,3,8,1630449.201315,5159982.80810885
1,11,3,2,2,0,7,1833419.51490519,4482537.02146961
0,22,4,1,0,0,5,1352928.66599213,4495986.89015246
1,18,5,2,1,2,10,1905835.21594431,5369885.22494461
0,27,2,1,1,0,4,1406412.27125933,2188027.86017673
0,34,4,2,1,5,12,2753318.08323848,5933257.23854123
0,12,2,1,0,6,9,1693427.50499504,4438165.41846951
1,20,0,1,2,2,5,1690772.90740884,4966317.7999978
0,40,1,0,1,6,8,1900385.63365926,5101479.36631896
0,30,1,3,2,2,8,1817006.38299683,4834673.07054865
0,37,1,3,2,1,7,2055759.5018497,3440509.03363278
0,20,0,3,1,3,7,1388258.68672795,4053739.60903734
1,38,0,3,0,3,6,1693824.22844294,3678036.29044843
1,20,3,2,2,7,14,2024949.04588171,8279223.82866903
1,15,0,1,2,6,9,1396692.93332562,5623720.98535686
0,26,2,3,2,7,14,2070175.7034827,5462694.87571489
0,37,1,2,0,2,5,1676498.00460019,6207486.57200768
1,15,3,1,0,6,10,1983226.52132945,4040305.20075382
0,10,3,0,0,3,6,1619751.84601705,1891890.85222892
0,28,2,3,2,7,14,2249344.74404329,2751482.41392744
0,16,2,3,1,0,6,1825818.7764274,1556306.83707773
0,32,3,2,1,6,12,2157037.52490217,6492571.58637861
0,28,1,3,2,1,7,1414712.96874889,6376468.37152172
0,24,0,2,1,2,5,1559403.18522973,3963509.30805475
0,21,4,1,1,6,12,1870141.79845652,7177363.45245819
0,16,2,2,2,6,12,2015249.48216183,5294933.26117116
0,39,1,0,1,2,4,1093014.90042797,5160751.56163835
0,33,3,0,2,7,12,2613678.24492458,5131010.39414067
0,21,5,0,1,5,11,2717004.68986573,3180245.86232808
0,18,2,1,0,5,8,2261585.23206809,4552606.01725257
0,34,4,0,1,0,5,1667099.83554912,2719895.21293509
0,37,6,2,1,3,12,2884362.3201666,9141446.26672222
0,15,2,2,0,4,8,1756932.33452981,2976024.04611978
0,10,2,2,2,7,13,3088914.06911839,7406750.54541543
0,10,6,0,1,5,12,1652175.34713266,5243415.4376428
0,13,4,1,1,5,11,2640596.91852531,4724204.19794364
0,34,2,1,1,7,11,2101753.23941634,3440592.17797381
0,14,1,0,0,7,8,1873749.1596189,6565968.3709203
0,37,1,3,0,1,5,1210975.95573901,6514812.76115243
1,19,6,3,0,6,15,2437858.03673139,5185849.07552621
0,40,1,2,0,3,6,1629349.41335659,5365420.35336445
1,19,1,2,1,1,5,1901770.45620557,5042561.27993063
0,24,1,3,1,4,9,1984767.30892657,8779628.30427159
0,31,0,2,2,7,11,2622040.03917197,4138214.9443004
0,23,6,3,2,2,13,2571132.80189497,10959114.0648329
0,32,1,1,2,3,7,2002660.33893397,3486879.24416257
0,33,6,3,0,6,15,3240084.81156819,10246321.5026885
0,19,3,2,2,7,14,2121244.78958351,6209594.84801338
0,40,6,3,0,1,10,2925699.73684485,3011411.62111396
0,27,0,2,1,4,7,1803429.56742746,6131511.15699629
0,22,0,3,2,6,11,2327560.21833265,6391221.05119277
0,40,4,0,0,1,5,1442399.39250689,3710403.66782981
0,11,1,1,1,1,4,2083790.2982818,5468358.52340331
1,22,3,3,1,6,13,3114009.36911413,6791868.71569812
0,16,2,0,1,3,6,1628499.26847851,6966241.81041116
0,21,1,2,0,2,5,1762078.41148492,5255105.73727446
1,17,0,0,2,5,7,2196516.24555268,5627533.44884468
0,27,6,2,0,4,12,2202341.6610695,1197569.1783187
0,35,1,3,2,1,7,1686779.70693854,5932917.39378222
0,34,4,0,0,4,8,1665337.6212866,4862828.11612493
0,24,1,3,1,0,5,1306299.51898699,5969819.48633771
1,13,6,2,0,7,15,3544807.36493205,8535788.22072463
1,17,0,1,2,4,7,2012247.90016328,4950051.38883818
0,23,5,0,1,3,9,2295564.85288335,6506616.22530149
0,28,6,0,0,3,9,2295083.72042366,3280396.52632277
0,26,1,2,0,7,10,2123468.80939855,5727804.52183991
0,34,2,3,2,1,8,2046726.95542427,8662358.86149335
1,20,4,3,1,3,11,2366222.80977488,5847544.92271933
0,40,1,2,1,3,7,1572464.72489595,7880092.88091112
0,22,5,3,2,7,17,2806050.8021714,7744344.41868314
0,22,4,2,1,3,10,1989364.87093642,3882431.06701179
1,18,1,0,0,0,1,1107943.43539801,1761971.73432506
1,15,2,1,0,3,6,2025707.06840158,4668958.86479111
0,25,0,0,0,1,1,917892.119436955,2849230.51853176
0,24,4,1,2,1,8,1717680.41368955,3857642.68123444
0,29,6,2,2,1,11,2325998.70337722,7765531.60590319
0,22,0,1,1,2,4,1055893.51419025,5085599.5353503
0,13,1,3,0,4,8,1301913.49881189,4871819.05112842
0,30,1,2,2,6,11,1904841.6218288,7543336.79237192
0,24,6,0,1,1,8,1397822.14736299,6054975.77013037
0,36,3,1,2,3,9,1610797.80590043,3158020.47612362
0,32,0,3,1,0,4,1721500.55286804,4778594.92452857
0,26,1,2,1,2,6,1771136.56930735,3649837.55845848
1,33,3,3,0,0,6,1559520.34636526,5216073.09821102
0,21,1,3,2,6,12,2378969.29560339,7835205.39423507
1,30,0,1,1,5,7,1856781.15101556,5084672.09058382
0,38,6,0,0,4,10,1878174.61499982,7534120.32554423
0,34,0,1,2,4,7,2267461.85395535,4103540.90713888
0,18,6,0,2,5,13,2045410.10774376,6378999.74672392
0,31,3,0,0,3,6,1435925.95440184,3541526.4961799
0,23,0,3,1,1,5,1490104.27743195,4103111.77633405
1,20,2,0,0,3,5,1722823.49818822,3711401.06536726
0,39,5,2,2,2,11,1987026.3812514,3462215.75895881
0,37,6,1,0,4,11,2162532.49127533,9442411.91734777
1,37,2,2,2,0,6,1143030.33402507,4104251.64566941
0,40,4,0,0,0,4,1486889.73019891,6565300.35898411
0,12,2,3,2,5,12,2537319.41756385,5694891.0419015
0,28,1,2,1,0,4,1295079.37098069,6875263.2664706
0,32,1,1,2,5,9,1984579.17335568,5632689.02649751
1,28,5,3,2,3,13,2769198.6603899,6589889.30340888
0,12,4,0,1,2,7,1540471.43651202,3986786.89925225
0,40,3,3,2,5,13,2226368.35075256,10302557.8369159
0,33,5,1,2,7,15,2779789.01298559,10891102.9912668
0,20,6,0,2,3,11,2413742.70609702,6356773.09633234
1,31,6,2,2,1,11,2452173.15067693,5838415.89602036
1,12,5,0,2,2,9,2397202.2563654,8645869.62173641
0,36,3,0,0,2,5,1306147.04306831,5179248.52891241
0,23,3,0,2,3,8,1357383.01604338,889690.737047254
1,26,3,3,0,3,9,1770076.48272293,7216708.11504023
1,21,6,3,1,0,10,2445355.95863726,4057935.87121016
0,27,6,1,1,4,12,2512113.67480524,7108508.95209227
0,36,1,1,1,5,8,1704900.87396035,3614909.76448607
0,22,0,1,0,1,2,1278954.70232462,3054335.60003863
1,20,0,2,0,7,9,1868188.62580282,4696128.90793595
0,20,5,3,0,2,10,1723859.63796222,7104675.16384262
0,32,6,2,0,6,14,2939677.94835512,3820533.56754294
1,23,0,3,2,7,12,1999898.52259777,7748403.08668287
1,31,0,2,0,0,2,1177702.58473789,3358204.80760827
0,37,4,3,1,1,9,1983994.81329611,2586395.35009322
0,23,5,2,1,6,14,2777070.20141893,8513533.82016964
0,34,4,1,0,1,6,1406150.79704809,5362520.43784006
1,11,4,3,2,0,9,2088678.13950309,6978330.29870093
0,32,6,3,1,2,12,1846658.01097969,8214147.67623623
0,15,1,2,1,5,9,1668964.08269099,6885876.2260399
0,37,6,3,2,1,12,1959715.89902402,6896436.2915415
1,27,0,0,1,6,7,1843530.93887941,4391984.13293037
0,17,1,0,1,0,2,1122948.8643644,6051185.02372523
0,27,6,0,1,0,7,1997699.17064294,4094454.03528688
0,18,3,0,2,0,5,1159641.11443986,4887324.53328403
1,20,0,1,0,4,5,1627983.50697078,3466209.49803491
0,33,1,0,0,3,4,1351878.32716839,3178280.26761441
1,25,6,0,2,1,9,1890041.2080455,5641351.22909024
0,13,6,2,1,7,16,3423383.60956365,9318745.97928724
0,29,6,1,0,1,8,1611268.26463876,6997469.87356131
0,17,5,3,1,6,15,2522355.37778164,7682331.2955466
0,34,4,3,1,0,8,1673038.97494737,5657017.57451903
0,10,6,0,1,2,9,2005295.27121752,6608384.2383336
0,23,0,0,1,0,1,1091869.01980143,1303794.66145873
0,24,5,3,0,2,10,2195534.92285371,2332873.57416832
0,35,4,2,2,7,15,2767822.79201439,5385392.45797606
0,12,5,0,0,0,5,899534.997588552,4612064.26919096
1,19,3,0,2,2,7,1904900.84210093,4206395.84536629
0,27,3,3,2,4,12,2280149.02320387,7416038.33352844
0,14,5,2,2,4,13,2163436.98695513,3947102.50037172
0,28,3,3,0,4,10,1984753.44471856,5616866.80073405
0,16,5,0,2,4,11,1475768.32324609,6364053.78780954
0,15,2,3,1,5,11,2356241.15030495,8151826.0418128
1,38,2,0,1,1,4,1213287.83276275,6131747.18608583
1,16,2,2,0,5,9,2419119.95876974,3203289.64393033
1,29,1,1,0,1,3,1552335.7251327,5014143.69709626
1,30,3,3,0,6,12,2319979.34640891,7611531.33651471
0,26,5,2,0,3,10,2213065.19442143,8887893.92152151
0,12,1,3,0,5,9,1779833.86715614,7998619.71566111
1,30,6,1,1,5,13,2353011.53461695,7556586.7813353
0,10,2,3,1,4,10,1656478.48734471,6510457.94028937
0,26,5,3,2,4,14,2757869.02433845,8604277.00607596
0,37,5,1,2,1,9,2257098.22918434,6538924.48329652
1,27,2,2,1,7,12,2077026.18937475,8089400.42935903
0,26,4,1,1,0,6,1676569.1114947,5043323.29656881
1,37,2,1,0,1,4,1443847.24914695,3189995.40606038
0,22,3,0,2,3,8,1966065.78860859,3981203.88579142
1,24,0,0,2,4,6,1792333.14046468,9174092.99913387
1,29,5,3,1,7,16,2380548.53294837,8603518.45389384
0,11,4,3,1,1,9,1432090.66046967,3221099.27690068
1,35,3,2,1,1,7,1643783.49477678,8740424.59916295
0,23,1,1,2,4,8,1816726.23361517,4664468.17257938
0,22,3,2,1,4,10,1985795.14811536,6677818.56289299
1,17,2,3,0,5,10,1929419.13871396,7421184.75039727
0,28,5,1,1,3,10,1735412.72738245,6229936.78561937
0,38,2,3,1,2,8,1779290.80860556,5113235.70351097
0,25,1,2,1,3,7,1906363.01043059,5790263.66548898
0,23,3,3,0,7,13,3620709.13116022,4940771.1883543
0,24,6,3,0,4,13,2422150.29529797,7427751.50641646
0,14,2,2,2,7,13,1880296.11510979,6806444.46846745
0,15,3,2,1,2,8,1952434.09583218,4856450.4694569
0,19,5,1,2,5,13,1799929.99484512,9591965.27752459
0,30,1,0,1,7,9,1834310.9487852,8259937.41765649
0,30,2,0,0,3,5,1473111.16249183,5853657.5178461
0,29,2,2,0,3,7,1746075.85598972,7451487.60962438
0,12,4,2,0,5,11,1470401.09175682,4999634.37618413
1,15,3,3,0,3,9,1499340.36215598,5483065.21229183
1,35,0,2,1,6,9,1929568.36483332,9086851.87932447
1,40,0,2,1,1,4,1153657.96093741,1203398.38468713
1,37,0,1,0,7,8,1495532.66877437,6199056.80599004
1,37,5,2,0,1,8,1958560.87667079,5659463.20567337
0,24,1,0,2,6,9,1865593.95309693,4067675.35073142
0,27,3,1,1,7,12,2311302.30417724,8499472.07026578
0,33,2,2,0,3,7,1871484.67309728,5436831.53127724
0,36,6,1,0,7,14,2092862.13761709,7902814.60856535
0,40,1,1,1,3,6,1534008.17340248,3939978.14622877
0,10,3,0,0,4,7,1324450.80649936,4434051.40740151
0,12,3,0,1,2,6,1552980.76076934,3806467.4102283
0,35,5,0,2,5,12,2562698.00472754,5472568.34254891
0,20,4,0,0,1,5,1137805.32468645,4484052.61189504
0,14,6,1,0,5,12,1211366.98820126,5877960.6098091
0,39,1,3,1,2,7,1308672.36602308,3272721.53069984
0,30,0,3,0,0,3,1254655.13732305,519165.094949819
1,13,4,3,2,2,11,1722274.85513261,6348599.8854985
0,10,2,3,0,6,11,1553567.16285467,8849150.24766014
0,12,3,1,2,2,8,1844276.61364249,7136253.63762496
0,40,6,3,2,0,11,2243942.55172921,8139551.94156756
0,25,5,3,1,6,15,3470104.92080419,7287842.49585792
1,32,5,0,0,2,7,1339131.80597249,4690490.21994555
1,22,3,3,1,2,9,2108179.66671661,7079801.64693288
0,16,4,3,2,2,11,1632550.77046461,3997042.55500549
0,30,1,1,1,7,10,1540563.15342918,11895062.3199099
0,12,5,1,0,0,6,1543003.04309546,5581470.57602321
0,18,5,0,0,0,5,1706022.19565198,3065087.59621251
0,18,6,1,0,4,11,2138967.54675768,6380231.14274167
1,13,5,0,1,3,9,1602271.7895128,6634058.66061178
0,26,3,0,1,5,9,1857683.75351985,3605301.12918869
1,24,1,0,0,6,7,1993086.18127308,3978076.9986991
1,22,0,3,0,1,4,1666945.17663115,4607564.847886
0,27,2,2,1,1,6,1966486.73532452,2454244.31875776
1,20,2,1,0,1,4,1280532.6759339,5099141.51882982
1,21,5,0,0,6,11,1952219.32177013,3097947.39187899
1,14,6,2,0,7,15,2286736.86367604,8871454.58762117
1,11,5,1,1,1,8,2109446.07124244,951191.451431539
0,33,3,2,2,1,8,2096676.38128023,5423582.00281658
0,20,6,2,0,7,15,2370450.07609987,9083579.34359888
0,35,6,0,2,0,8,1907933.28671571,4031707.38508542
0,35,0,3,0,0,3,1197571.03001238,1513297.44147957
0,13,3,0,2,5,10,1720908.33088516,3019945.74813062
0,35,3,3,0,6,12,2167752.93169705,6260774.29580582
1,10,6,2,2,3,13,2363500.18620645,8279419.65854496
1,37,1,3,2,6,12,2374830.89480798,5828462.50453841
0,23,0,2,0,3,5,2061233.6064159,3410560.22533502
1,13,4,2,2,5,13,2305700.23505892,7281456.4882968
0,20,0,1,2,1,4,1424679.51150635,5064530.71007536
0,16,3,3,2,1,9,1988580.8064663,5328151.7484327
0,22,6,2,0,5,13,2233775.18630245,6482051.04519543
0,25,5,3,1,0,9,1679396.68959849,3757549.76913419
0,23,2,3,0,3,8,1425143.24561426,5011852.54468298
0,17,0,2,2,3,7,1651627.93985279,4537263.6480559
1,25,3,1,0,2,6,2119041.33772679,3511041.81033099
0,29,1,2,2,2,7,2216527.15064227,9092561.86521391
0,14,1,3,1,3,8,2360158.59358649,6126644.33635197
0,40,6,2,1,3,12,2175630.82694366,7637789.48869692
0,39,4,3,2,7,16,3278312.46200114,9724784.13532837
0,32,0,3,0,2,5,1646848.29337055,2140512.51855388
0,19,2,2,0,4,8,1922774.5973732,5830098.41399605
0,23,3,2,1,0,6,1414228.1005463,1493228.2818201
1,35,5,1,0,2,8,1752303.20228332,3728961.38327329
0,33,4,1,2,4,11,2375365.77701788,5059878.95748235
1,32,4,3,1,1,9,2016390.98495448,7490999.20056662
0,27,1,2,2,7,12,2376791.94871111,7589521.59765626
0,23,6,1,1,3,11,1795359.08587876,1364982.88884577
0,34,0,1,1,7,9,2227804.14141509,8614440.07543725
0,19,2,0,2,4,8,1875646.99962315,4155775.32575682
0,24,1,0,0,5,6,2042338.90444306,5612246.31204334
1,39,3,3,0,7,13,2319029.6318646,7824065.77376492
0,30,0,1,2,0,3,1190872.8132046,5018479.47857297
0,23,6,1,2,6,15,2851452.7422446,6281184.02605523
0,33,2,3,2,1,8,1754718.87172416,2762529.50699585
1,20,3,0,0,2,5,1564485.52179769,6641250.2019996
1,17,2,1,2,6,11,2312823.13420226,7021505.06358465
0,28,4,0,0,2,6,1405899.94471951,5002248.26325227
1,30,0,2,1,0,3,1484904.68565393,5151992.94186151
1,30,4,2,0,4,10,1603053.93813423,5500377.63612069
1,15,3,1,2,0,6,1536302.87355403,3478834.73250584
0,34,4,3,2,3,12,1485111.20398621,8539580.02051359
0,26,2,2,0,5,9,2112697.83185673,5960925.60384389
0,31,1,3,0,2,6,1577333.03394129,3673582.32430844
1,32,3,1,0,6,10,1776474.46800399,6645585.01075114
0,21,2,3,0,2,7,2000157.04261345,4647531.02956066
0,35,3,1,0,6,10,2269662.10167889,8754393.32720207
0,22,2,2,0,0,4,1072684.96947451,3938546.39057521
0,29,5,3,1,7,16,2478329.09626733,12196847.6314073
1,32,2,1,2,2,7,1424176.38295511,4111496.86742994
0,11,3,1,2,5,11,2140797.42887924,6058804.84257307
1,18,6,3,1,1,11,2012809.34162474,3838172.4693489
0,27,0,0,1,3,4,1392303.65088108,2957724.47666118
1,10,6,1,0,6,13,2584222.33372847,5956199.01745768
0,19,1,0,2,3,6,1367821.89772792,3510898.31983945
0,26,1,0,1,0,2,1285487.31690502,1685511.11154664
0,33,6,2,2,4,14,2540339.50237524,7168876.34621897
1,31,6,3,1,5,15,2872166.07212458,6083315.7185932
0,14,4,2,0,2,8,2064613.1263677,4533483.22725576
0,11,6,3,2,4,15,2303563.35024448,8197535.81180215
1,25,1,0,0,4,5,1444555.32985723,3386155.46068077
1,30,5,2,2,7,16,2493008.88827594,6623914.31515376
0,28,2,1,0,5,8,1652561.82800442,7285159.55856081
0,19,0,1,2,6,9,2046043.03262782,3411834.14197798
0,28,2,0,1,3,6,1629727.33954063,5176060.62795476
0,18,4,3,1,7,15,3216017.60389699,8582065.71668572
1,19,1,2,0,3,6,1696054.18347156,4955242.5413493
1,38,2,0,0,2,4,1704772.3823579,2685533.31120111
0,33,3,1,2,4,10,1526934.03879922,3833455.38770334
0,36,2,3,2,5,12,3083450.47301042,3812056.36154747
1,22,5,0,1,0,6,1685321.97218699,5448385.04302097
1,24,4,0,0,3,7,1460137.22031614,7022496.06255952
0,19,5,2,2,3,12,2273674.14394099,6757745.79078018
1,32,0,3,1,4,8,1438173.11526527,2883117.23435771
0,26,2,2,0,4,8,1099887.6927593,4679058.47721942
1,33,0,1,1,4,6,1460820.14630988,7726862.69426744
0,22,6,3,0,1,10,2070494.57327949,3359487.60411403
0,21,4,3,2,3,12,1719637.70858834,6630347.85704265
0,39,3,0,2,4,9,1997246.7640772,4326599.12410532
0,24,0,1,1,0,2,1065984.46637984,1879395.93097046
0,13,3,1,2,6,12,2384758.39037319,6165725.33022123
0,23,5,1,1,1,8,1552191.96869588,4380474.42484686
0,40,4,3,2,3,12,2444933.73195226,9981105.27474227
0,10,0,0,1,4,5,1400726.97412406,1903779.07273843
1,17,0,0,2,0,2,1254378.88295032,6394734.34195401
1,40,5,3,1,7,16,3203963.63112896,7968157.81266648
0,25,1,2,2,2,7,1703291.68432753,5699679.99557449
0,32,2,3,2,5,12,1836491.12610531,7235610.75716014
0,36,6,0,1,6,13,2395567.60682802,9345080.64799019
0,20,1,2,0,2,5,1545894.35036128,5460434.70140434
1,27,5,3,0,3,11,1594569.13427447,5783687.41327267
0,40,1,3,1,3,8,1906168.15983958,6181877.38991205
0,29,5,2,1,4,12,1691319.66355721,5637226.94335619
0,13,2,1,2,2,7,1562391.47101126,2291603.65521928
0,21,5,0,2,6,13,2559178.76821568,8168663.27385331
1,36,3,1,0,6,10,1730634.68433195,6157689.82261064
0,29,5,1,2,6,14,2273762.97078752,4875998.31835689
0,19,2,3,0,4,9,2458023.85226811,5937997.06509529
0,39,2,1,1,5,9,1964238.39286602,6566764.18452302
0,40,0,2,0,0,2,877640.51673274,4963008.30195391
0,29,2,1,1,4,8,1742792.02299162,4192252.94211747
0,33,3,1,0,3,7,1831487.19231659,5024340.16134579
1,28,4,2,0,1,7,1797943.77850475,4130239.4379649
1,13,6,1,2,0,9,1413310.46641328,6416593.75909466
0,34,3,1,1,7,12,2300916.0061914,6597636.88522889
0,19,4,1,2,3,10,1927696.49559208,6629172.02090679
0,32,3,1,0,3,7,2067146.04499363,3065430.09017292
0,22,5,0,2,7,14,2706011.97771229,6760734.54952825
0,26,2,0,2,4,8,2267678.99071919,6301457.21951615
0,21,2,3,1,3,9,1724156.12226718,3629917.15416292
1,14,6,2,0,4,12,2454374.06577277,3926557.71565122
0,34,1,2,0,5,8,2323393.54828887,2841367.68444838
1,18,6,0,1,4,11,2098441.66687346,5265946.51234456
0,12,0,3,0,1,4,1327174.16360582,2450327.19975553
0,17,0,2,1,1,4,1204786.07594377,3135195.66846097
0,21,4,0,0,4,8,2318374.74801829,4126794.59468079
0,12,5,2,0,3,10,1937498.49870699,5039195.62923026
0,22,6,1,0,0,7,1282077.91287692,3274957.34294382
1,30,6,2,1,2,11,2499805.00481254,8589495.59911216
0,37,4,1,1,7,13,2241079.11007605,1814191.20209438
0,19,4,1,1,5,11,2087695.77377347,5980973.78404329
0,37,2,2,1,0,5,1967537.3166669,4170690.19083908
0,19,3,2,0,4,9,1559495.48279853,5824674.19220446
0,17,1,3,0,5,9,2139629.86067599,6372228.71328862
0,39,3,1,2,3,9,2127475.97042434,7194744.86196979
0,29,3,3,0,4,10,1908308.50453806,5472486.24013125
1,26,6,2,0,7,15,2234769.23330653,5358102.5140443
0,34,3,0,2,3,8,1275650.16245172,6236825.86064837
0,10,4,0,2,6,12,1379408.09211359,4356718.46624541
0,34,2,0,1,6,9,2384699.81698558,7058834.84793914
0,39,1,2,2,2,7,1597475.67464383,6997505.80398562
1,39,6,1,2,1,10,2316360.90033054,5058841.35079387
0,31,2,0,1,5,8,1460561.10051473,4893526.87235856
0,37,2,2,0,1,5,1502929.01292174,7367815.58404212
0,26,1,3,2,3,9,1277658.88292322,4990577.74676207
0,17,0,1,2,5,8,2324130.40065889,5461347.41902458
0,38,1,1,2,2,6,1882363.97911797,5629677.69564439
0,38,4,1,0,2,7,1495608.42849678,5422341.61891564
0,36,4,2,2,4,12,2992971.25269324,5893500.03588664
0,19,1,3,2,3,9,1862984.436122,7470851.40354817
0,34,1,1,2,0,4,1433622.03217503,4187762.00300071
1,40,6,1,2,1,10,1760241.5808738,5987296.01747346
1,32,6,0,1,2,9,1611919.82454948,5398416.06404518
1,36,3,1,2,3,9,2236684.90738717,6115107.52457877
0,23,2,1,0,4,7,1418576.36631265,2751416.31468412
0,18,4,1,1,5,11,1938936.6534225,9995076.22563149
0,29,2,1,1,4,8,1048429.52550482,5891036.08237982
1,22,3,3,1,7,14,2796912.6947433,8781536.56018828
1,19,2,2,0,6,10,1840397.92902852,6744604.92323044
1,32,4,1,1,5,11,2418713.35731469,5659881.27723759
0,33,6,1,2,5,14,2969306.66430689,10107020.6937515
0,21,3,2,0,6,11,2297180.23278541,7248934.63093496
1,34,0,1,1,0,2,1189963.01416609,5064116.82557955
0,17,4,0,2,3,9,1521093.37608876,2614917.79056414
0,24,4,0,0,3,7,2212451.22154073,3984707.65022426
0,14,6,0,0,0,6,1490176.62006499,3998246.23614819
0,19,1,1,1,7,10,1309132.83440823,7263876.57779835
1,40,1,1,0,4,6,2014587.08883607,3699388.65734361
0,36,0,0,1,4,5,1376435.21030403,3382820.70389095
0,13,5,2,0,3,10,1703050.08486269,3468760.11505768
0,22,3,1,1,1,6,1411146.74213299,4353815.44394821
1,11,5,1,1,5,12,1655409.97585554,3611403.83113913
1,27,1,3,0,5,9,1593634.41286136,3087377.85676534
0,11,3,1,1,1,6,1557705.71313857,8465179.20759165
0,15,3,3,0,6,12,1824760.80802806,6028747.32187072
1,29,3,1,1,4,9,1745910.71755457,4722420.00592648
0,38,1,0,2,6,9,2208559.49110309,4193582.20759506
0,17,6,2,0,1,9,1912256.7623028,4249107.39685003
1,27,3,1,1,7,12,2133951.96964903,6745427.71488621
0,29,1,2,1,5,9,1976190.52744767,7908051.18686972
1,20,4,2,2,4,12,1671203.09055294,7058401.99728163
1,17,1,1,0,7,9,2065458.96051436,1287918.39600751
1,36,2,0,0,4,6,1864910.25575346,4146991.68754706
0,17,2,2,2,4,10,1925598.52505082,5359939.23819132
1,13,1,0,0,1,2,1014530.13403607,6369977.32177373
1,31,0,3,1,6,10,1999320.2078245,7963917.1520581
1,13,1,2,0,4,7,1855938.70185152,8373110.10423388
0,26,5,2,2,1,10,2051144.11833686,3913657.39075758
0,28,5,3,1,0,9,1961198.94669468,6600404.49510566
0,22,4,0,0,7,11,2365648.21276484,4784405.98469689
0,24,5,3,2,1,11,2489557.24939429,9102676.77796893
0,11,3,3,0,4,10,2153005.46104921,4389498.05043164
0,13,2,2,0,1,5,1974024.99387716,8384826.77588205
1,10,3,0,2,4,9,1753682.73922947,6991807.24463111
1,25,3,3,1,1,8,1506551.38017432,6544163.71399372
0,35,0,0,0,1,1,970919.667166806,3006162.86200666
0,21,2,2,0,5,9,1639479.59957005,1692488.30615228
1,22,6,3,2,2,13,3071501.84224027,2578298.01247791
0,15,3,0,2,5,10,1886913.63776624,7650018.51179754
0,40,1,0,2,2,5,1714208.51778692,5945929.88094669
1,11,2,0,0,6,8,1747160.8332151,6057618.92492422
1,24,2,2,1,3,8,1923824.84616082,5856187.7672964
1,35,5,3,1,0,9,2239279.97966834,5308801.3447444
0,36,4,1,1,4,10,1107087.62676796,6279831.44779893
0,39,0,2,2,0,4,1714229.55874452,6118088.55056643
0,37,3,1,2,7,13,2467731.73476025,6655917.97217014
1,11,6,0,0,0,6,1652523.74699963,2402877.42637773
0,33,2,3,2,5,12,1941943.50844434,8412660.42777878
1,34,5,2,0,6,13,1867168.3441974,7883915.06259661
1,35,3,1,0,7,11,2208784.3167974,4215915.47281132
1,15,5,2,2,7,16,3190709.60382419,8643514.70944833
0,34,2,2,1,3,8,1915334.00447507,5176276.23128281
0,14,1,3,2,5,11,1800515.18257505,6425138.87627
0,13,0,3,2,6,11,2773130.88378016,7633766.95030677
1,22,0,2,1,5,8,1554440.29831492,6196602.94492927
0,23,4,2,0,6,12,2458271.24277278,8034624.11357757
0,22,6,1,1,7,15,3351572.58289923,5686277.94122375
0,18,3,1,2,6,12,2052645.77129318,6197524.20460744
1,10,0,2,2,3,7,1676905.23518722,3567207.35556785
0,13,0,3,2,6,11,2135153.09992494,7329365.43353883
0,33,3,3,2,3,11,2151973.43791586,8242209.9746242
0,21,2,2,0,7,11,1626123.57069794,5951589.91451878
0,27,5,0,0,6,11,1304993.92390139,7251236.66230873
0,38,4,1,1,6,12,2304251.37418536,1151301.44611163
0,38,4,3,1,1,9,1594112.66851822,5647936.16861288
0,14,0,2,2,7,11,2779727.2836244,7859954.2922049
0,12,2,1,0,3,6,1786343.88097355,6670076.53523613
0,36,6,3,2,7,18,2684959.20625896,7192038.18543374
0,27,4,2,2,5,13,1721937.93438857,8790812.8174048
0,31,6,0,1,5,12,2169337.73718171,5969211.53807736
1,14,5,3,1,1,10,1836870.15175334,5042162.84575883
0,30,0,0,2,5,7,1607244.08297856,6925044.04227647
0,24,0,0,1,2,3,1294148.3659657,6882997.57733172
0,20,2,2,2,0,6,1525924.55672261,4538592.9570088
0,22,4,3,2,6,15,2704134.38431795,6635335.5188358
1,18,4,1,0,1,6,1276645.59307449,4696318.07241519
0,38,0,3,2,7,12,2007778.24761907,3313464.17371699
1,23,1,0,2,4,7,1849350.57656266,2729332.31267867
0,11,2,0,2,6,10,2467852.7157673,3452370.91145312
0,30,2,3,0,7,12,2158253.71401965,5477538.21645081
0,13,2,1,0,1,4,1273482.96884851,4424573.23372116
0,21,2,3,0,2,7,1502680.2746213,3389964.23972984
0,13,1,0,0,4,5,1433540.64994627,1872517.78227277
0,32,6,0,0,4,10,2258032.31679734,3396328.65764391
1,28,3,0,1,1,5,1822537.72560513,4044122.01495446
1,36,3,0,0,1,4,1155164.17265883,1613212.06285658
1,27,5,0,0,3,8,1531010.01369716,4200459.9766646
0,10,0,3,1,7,11,2681904.47728432,4248350.22798069
0,39,2,1,0,5,8,1939283.13449313,4573464.64100844
0,13,2,3,0,4,9,1870292.56705565,5585099.06882543
1,27,3,3,0,3,9,1567935.73207534,6520932.46593368
1,12,4,0,1,4,9,1621731.51198558,6132503.89308254
0,29,3,1,1,0,5,1283264.14693783,6274995.20826942
0,36,0,0,0,1,1,1057128.2109169,1710114.48900977
1,21,3,2,1,1,7,1213083.75200393,5465819.59210391
0,12,5,3,1,5,14,2445388.1767125,5986945.48416788
1,14,0,0,1,6,7,1691973.68108107,1614258.36528635
0,10,5,3,0,7,15,3297059.62554073,11365108.8857493
0,34,5,0,1,3,9,2110089.34776664,4318881.65154513
0,11,3,1,1,3,8,1757392.36450414,6375131.3186996
0,12,4,2,2,1,9,1824500.57405187,2612816.13616128
0,21,3,1,0,3,7,1670830.1085592,2332330.98812175
1,33,2,2,2,1,7,1326310.92706189,6218922.45405929
0,13,2,3,2,4,11,2571757.63686906,4553393.93466674
0,24,6,2,2,3,13,2404333.69189014,5637393.29746272
0,32,2,0,0,6,8,1729415.72237107,3883491.36381025
1,29,2,0,2,0,4,1371344.84939848,6444803.33141107
0,25,1,1,0,7,9,2221183.95278938,3802638.81308729
0,37,2,3,0,1,6,1634012.91248029,3840544.98093407
0,15,4,3,0,5,12,2420848.8467154,6045882.74454492
0,30,4,0,0,7,11,2284691.25522698,3572913.03362011
1,24,4,3,1,1,9,1786993.22528817,5829282.02520501
0,27,0,0,0,5,5,1827219.66507143,4888675.93320974
0,17,1,3,0,3,7,1566330.58271246,5942485.36629611
0,10,0,0,0,7,7,2067484.90735128,5231395.57100243
0,13,2,3,2,7,14,2671347.53105072,8721514.22199995
0,40,5,0,1,4,10,1189793.20862761,6339603.92645426
1,26,4,2,1,3,10,2201911.78504093,3740317.31289078
1,22,5,0,0,7,12,1818917.36815511,6181675.78033529
1,23,6,3,0,0,9,1872767.37010002,5841003.10842818
1,33,6,2,0,5,13,2260037.0894996,6965856.74100455
0,13,0,0,1,3,4,1253996.60817688,4436832.89569715
0,33,2,1,1,0,4,1544943.87943715,2335824.06279216
0,18,4,3,0,0,7,2002134.56918431,2875455.13569384
0,38,5,2,0,6,13,2469127.40959034,8097214.03980043
0,36,6,1,0,6,13,1862886.60551359,6943462.78621586
0,29,4,0,0,0,4,1645142.00385378,5210364.94462861
0,28,1,3,1,1,6,1655360.63458399,6331881.3595965
0,13,0,2,1,6,9,1807417.48826149,6113429.11259667
0,30,0,0,1,0,1,1231232.60530844,2655039.8003332
0,23,4,0,2,6,12,1616200.17603638,4743025.24995797
0,40,6,1,0,3,10,1796432.18062356,6567128.03726742
1,40,4,0,1,2,7,1790237.04493931,6358781.91911753
0,40,1,3,0,6,10,2401808.48756484,2040954.09067053
0,40,3,3,0,6,12,2299476.267281,4528604.69188598
1,19,1,3,1,7,12,2342783.81533873,6399019.39803387
1,36,3,2,0,5,10,2090618.91916401,6641012.43792507
1,30,2,0,2,2,6,1930786.63968806,3493332.72352769
0,37,1,1,2,5,9,2615483.54618823,1820335.55958792
0,22,6,2,2,3,13,2454772.15855412,11130544.4969786
0,14,6,2,2,6,16,2009641.50649849,11847063.9154798
0,19,4,1,0,3,8,1632415.79726511,4338179.71422578
0,22,2,1,1,2,6,1253026.46637196,4855191.25015883
0,19,6,3,1,1,11,2168651.87274315,6356935.98808376
0,39,1,1,2,6,10,1964577.43808896,4472125.71910624
0,27,0,0,1,1,2,1250457.45129205,5398693.74512176
1,35,3,1,0,7,11,2181218.75720301,3516453.38827702
0,14,2,2,2,0,6,1513445.28469061,6871536.19474222
0,35,4,1,2,5,12,1771049.3763001,6466769.42602248
1,26,1,2,1,5,9,2291789.68917917,8051049.4240364
0,23,6,2,2,3,13,3106325.00390475,6402821.23209366
1,13,3,3,0,4,10,1810557.54147321,4799355.61226704
0,18,5,1,1,6,13,2564038.51943331,7686233.45339645
1,19,6,0,2,2,10,2114058.57739619,4625519.79709521
0,40,6,1,0,2,9,1979577.68500707,6073741.53772892
1,33,3,1,2,6,12,2145959.13380859,7449718.17933876
0,18,6,2,1,4,13,2131339.24040674,10427433.7882603
1,40,5,2,0,1,8,1557763.12753024,5155909.71439016
0,19,5,2,0,1,8,1511610.01437031,6723602.38451255
0,33,3,0,0,2,5,1404325.32683324,3934034.56667005
1,40,4,2,1,0,7,1959730.53785903,5900921.75914832
0,11,4,3,2,3,12,2065186.66144491,5675857.66598483
1,40,2,1,0,0,3,1212666.14449905,3876338.25619889
0,36,0,1,2,4,7,1980803.47085223,6458778.46674049
1,30,1,0,0,1,2,942740.387144241,5004981.94013788
0,40,5,3,2,0,10,1866471.82066077,6532480.45101225
0,14,1,0,2,3,6,1389379.43815633,4907105.74276596
0,31,0,0,1,3,4,1474586.96355373,2851011.12584081
0,26,5,3,0,6,14,2430194.30875043,9585067.00134416
0,16,5,3,0,3,11,2332452.12812182,5236007.49992021
1,34,0,1,2,3,6,1251528.12912143,5330260.56562529
0,20,6,0,2,0,8,1564819.6238628,6076087.73224694
0,35,5,2,1,5,13,1630354.92196077,9638487.42365731
1,25,0,1,1,0,2,889168.578838219,2634748.63559895
0,25,1,2,0,2,5,1544333.70277959,2123056.95167613
0,29,2,2,1,5,10,2324889.23971693,6905280.67387165
1,21,6,3,0,4,13,2008809.54105936,6910636.13559306
1,21,5,3,2,0,10,2290588.25542244,5559291.33740043
0,39,1,2,2,4,9,2474389.33891706,5803768.86739033
0,37,3,3,1,5,12,2208450.84880333,5001600.63597355
0,25,4,3,0,1,8,1598753.84932418,5202151.53923715
0,23,4,3,2,0,9,2169129.90649167,5008234.15768137
1,18,4,0,2,2,8,1847738.13000371,6099036.90683346
0,20,6,2,0,1,9,2298914.61319226,6681779.62724761
0,14,1,3,0,3,7,1849117.82606592,4356908.21837485
0,37,2,3,0,2,7,1757421.58240859,1838846.82124604
1,32,2,1,2,4,9,1805906.83757274,10131451.5565766
1,25,4,0,2,3,9,2237463.56221419,4154814.19598818
1,23,6,2,1,3,12,2101073.46630681,6353195.27931414
0,29,0,0,1,4,5,1765534.74315427,4130106.19110931
0,25,4,3,2,1,10,2491840.72363632,4899249.47169053
0,13,2,2,2,3,9,2221349.13999868,5557976.76997025
0,22,2,3,1,1,7,1216706.09226009,3416360.25797584
0,23,1,2,2,6,11,1615078.36585605,4104137.85926208
1,40,2,3,0,3,8,1634413.83486763,4034936.34143755
1,22,5,3,0,4,12,1947168.12565056,6488386.33083594
0,20,1,3,2,7,13,1986170.07981144,8237821.57229439
0,14,4,3,2,0,9,2402170.65947622,5638899.05769594
0,27,3,0,1,3,7,1587366.44335042,3816170.51064752
0,26,5,1,2,7,15,2629507.72367542,5141007.3490577
1,40,2,2,2,2,8,2060901.71806818,8689596.87754899
1,15,1,2,2,7,12,1975193.08451436,7311268.86026692
0,37,4,1,0,7,12,1680321.79800846,9789574.85609151
0,19,4,3,2,7,16,2114618.84567587,6540029.33206881
0,22,5,2,1,7,15,2639435.12979888,3434341.51455392
0,23,5,1,2,5,13,1847685.15799284,4629109.8236226
0,11,4,3,1,0,8,2006107.91775054,7663928.20714964
0,18,1,1,0,2,4,1047122.92537572,4004044.45692677
0,18,0,1,0,3,4,1451360.52403673,3693315.04319646
0,19,5,2,0,2,9,2138540.12727199,1113262.15506166
1,39,4,0,1,2,7,1541897.16982298,3429531.1820551
0,13,0,3,0,5,8,1663875.53497238,6660513.71475909
0,12,5,2,0,2,9,1894765.74785878,5747579.71164433
1,34,6,2,1,4,13,2604308.86347672,9733442.82832093
1,35,0,2,2,2,6,1257181.89793279,2800009.80319016
0,16,3,3,0,3,9,1903694.36360687,4787559.97094012
0,15,3,1,1,3,8,1415312.85962279,6919265.7961347
0,31,4,2,1,0,7,1397255.11974181,6316729.60918378
1,20,6,1,1,1,9,1964766.08273035,3794948.58015408
1,25,3,1,0,5,9,1262439.49427674,4058106.00609642
0,10,0,3,0,3,6,1862178.33223706,2874559.85374925
0,12,6,1,2,5,14,2446386.06611531,7595002.85488978
0,19,0,1,0,7,8,2318616.4288617,6797246.33827137
0,23,0,2,0,1,3,1434680.72476645,3375616.75866899
0,27,3,0,0,5,8,1695851.69261594,8470880.23553215
1,40,0,3,2,3,8,1608660.93487637,6656632.03285721
1,22,0,0,0,6,6,1767069.74835979,5101456.23360991
0,33,5,0,2,0,7,1811777.88939415,4535078.21980133
0,35,1,0,1,5,7,1726780.19266551,1852548.50334149
1,30,4,0,1,1,6,1560340.61441155,5956737.80109871
0,30,3,1,2,7,13,2632748.88135259,9028926.66004327
0,28,4,3,1,7,15,2113008.66002291,7811178.94893823
0,37,3,0,1,3,7,2425798.30777118,2637848.53202689
0,28,6,3,2,6,17,3237535.86248654,6870838.76714327
0,27,3,3,2,0,8,2247361.21682401,4725428.85162924
1,32,4,3,0,0,7,1766929.92707051,4504218.23992636
0,39,3,0,2,1,6,1524270.2532418,6062877.89904197
0,39,3,2,2,7,14,2634792.21188311,5799736.20704855
1,31,6,1,1,5,13,2622771.91384258,4325530.13724599
1,38,0,0,1,6,7,1680844.45075773,7508828.57041982
1,11,1,3,1,1,6,1439283.62414013,2573713.14841542
0,39,2,1,0,0,3,1145374.23812688,3144678.05785685
1,25,5,1,0,3,9,1208660.99582666,7571677.44534149
0,19,2,3,2,4,11,2144509.93604401,6436019.03280092
0,38,0,1,2,2,5,1371861.30572203,5120113.88822604
0,39,3,1,2,3,9,1508418.4460326,8435119.36868265
0,13,2,1,0,3,6,1660712.54080534,5880875.9817884
0,14,5,0,1,0,6,2016720.99278644,2290214.91987817
1,36,3,1,1,5,10,2421881.87861431,4640995.80480641
0,20,3,1,2,6,12,2120106.44056422,9226830.11376786
1,36,1,1,0,3,5,898529.725412566,6549487.71164282
0,10,6,1,1,3,11,1491793.11970347,6461146.89351695
0,34,1,2,1,6,10,2184432.19527876,2744093.51017639
0,28,6,2,1,3,12,2906351.59795087,3655143.22202649
0,26,0,0,0,7,7,1521994.43122838,7277962.82944304
0,19,0,3,1,4,8,1654360.80167584,5555487.52813644
0,31,5,2,2,6,15,2083769.24123686,5638904.90782306
0,39,0,1,2,0,3,1511771.88042261,1511771.88042261
1,38,4,1,0,7,12,2097767.49959372,5710992.58686256
0,30,2,0,2,0,4,900735.348795059,1052566.59007399
0,26,5,0,1,5,11,1454138.66033553,6541253.6164221
0,35,4,2,2,3,11,2168835.9374313,4379649.24457679
0,22,6,1,2,0,9,2654768.45521143,6444387.86344551
0,18,2,1,0,7,10,1989358.73637037,4294118.33582648
0,21,4,2,2,7,15,2710335.8900759,6360325.29468055
0,23,4,3,2,6,15,2618063.29249296,9550403.03586659
0,11,3,1,2,4,10,1885713.25039454,7588599.08038486
0,39,2,0,2,1,5,1354026.51123273,6285360.49011129
0,24,3,2,0,0,5,1431990.75899233,4069579.52724819
0,39,3,0,0,6,9,1598497.28557887,6039349.17008633
1,17,2,0,0,1,3,1602856.06632285,1561676.28756602
0,23,0,1,0,3,4,1495392.63247592,4981894.3805313
1,38,6,1,2,3,12,2526101.48423438,3643019.543404
0,23,4,2,0,7,13,1792373.29682878,5062627.78396884
0,35,3,2,2,0,7,1841766.19165606,2884441.08860701
0,33,3,1,0,6,10,1885775.736941,5161181.70771987
1,20,3,1,0,6,10,1763728.5306726,8686956.95779407
0,20,4,2,2,2,10,2050417.34329045,7217366.99743195
1,31,3,1,0,7,11,2281074.1024457,5231187.27314441
0,24,3,3,1,2,9,1944190.63025606,7617535.36009196
0,39,0,2,2,0,4,1579014.00260665,4054718.50710678
0,13,5,3,0,7,15,2113299.82834075,7149709.46579256
0,25,0,1,1,7,9,1540017.65497836,6375931.57781231
0,10,0,3,1,5,9,2087857.25659672,3794645.13514366
0,26,1,3,2,5,11,2203656.42610982,8040038.0881748
0,24,0,3,1,5,9,1660869.43232016,5480107.87520889
0,37,3,1,1,4,9,1639049.08603936,5590044.82979206
0,16,6,0,0,2,8,1874797.06822711,7094522.38459548
0,23,1,1,2,3,7,2083030.56970875,4436669.92930121
1,36,3,1,0,0,4,1881345.66950102,5378117.47253087
1,15,3,2,2,5,12,2423966.34266346,5156996.88211857
0,11,1,2,2,0,5,1780529.36004038,3605795.66823199
1,12,1,2,0,0,3,1051261.79821614,1426689.057802
1,16,4,2,0,5,11,1987053.06170296,4810094.20379287
0,11,1,1,1,3,6,1473084.40939337,4399041.88774484
0,12,5,2,1,4,12,2085929.80400611,7024681.85649657
0,18,4,3,2,0,9,1957677.54354444,7069415.32744398
1,13,1,3,2,6,12,2565014.83079922,3784584.47066736
0,37,5,1,2,5,13,2573705.27295707,8877625.01183428
0,38,5,1,1,1,8,1778109.77569633,6523654.09061213
0,12,0,3,0,4,7,1707955.75162727,3060598.394928
1,38,1,0,1,4,6,1765754.07064309,4785032.66734424
0,16,5,0,1,5,11,2089259.84161336,9919141.96745827
1,27,1,0,2,1,4,1486692.59584643,1486692.59584643
0,14,5,3,0,3,11,3091802.49755316,5766816.49248261
0,33,1,2,2,7,12,2475396.19675559,8602602.56412083
1,39,5,0,0,2,7,2123585.57471191,2603271.48336313
1,28,5,0,0,2,7,1196944.63544256,5215326.43438807
0,22,5,2,1,1,9,1922462.85184992,6656801.35325922
0,11,4,2,0,2,8,1787969.68689537,5245438.52658576
0,23,0,1,1,7,9,1837492.59417237,5638359.03215012
1,14,2,3,0,2,7,1352124.46646966,4969448.55977003
0,31,0,2,0,3,5,1631105.43138979,1289206.50697333
0,22,5,1,0,3,9,1833000.00283625,5350312.59544035
0,36,4,1,2,3,10,1450087.34791042,6889151.32364245
0,34,2,2,1,0,5,1732432.0264644,2817558.49206705
0,11,1,1,0,4,6,1919142.00344576,4787237.3374843
0,35,1,0,0,4,5,1373177.66178153,5699896.01494996
1,34,3,2,1,3,9,1724116.33071543,6878685.47550736
0,17,0,0,0,5,5,1601389.45968571,3477534.35426324
1,27,3,3,1,4,11,1773750.11477608,9337729.65041047
0,15,4,0,2,5,11,2034531.13961191,8886114.4901433
0,23,4,0,2,7,13,1597821.44617446,11161868.630199
1,18,2,3,1,6,12,2304820.84312374,6290745.69062404
1,29,6,0,0,2,8,1689194.07459936,6863535.6526059
0,10,2,2,1,6,11,2683709.63640061,3011553.44366947
1,40,1,2,1,0,4,1261264.76287311,1959675.18906699
1,36,4,0,2,7,13,2304459.53037817,1335910.56499067
0,15,3,3,2,3,11,2086326.68407395,5091873.16096264
0,32,2,3,1,3,9,2292599.9304796,4359028.80506906
0,19,0,1,1,7,9,1650114.13598271,7755505.74787457
1,21,3,1,2,2,8,1266079.00864578,5646358.32008596
0,33,6,1,2,0,9,1863250.74158093,5890708.87432596
1,13,1,3,1,2,7,1818147.49040301,4817906.8000987
1,10,3,0,1,5,9,1809061.22333944,5777626.89136606
1,36,1,2,2,5,10,1929051.01997649,6240622.62435156
0,34,6,2,1,7,16,2625596.49157181,10205007.078627
0,12,6,1,0,7,14,1982670.19879492,5774836.25483353
0,30,6,3,0,2,11,2513451.10443216,11073339.6111062
0,13,5,3,1,1,10,1672686.71116727,4657846.83351196
1,29,6,3,0,2,11,2730441.3910288,7671450.20786267
0,25,5,1,2,4,12,2731174.42069895,3744980.39451227
1,26,3,3,0,0,6,1572119.26170399,3646317.03157878
1,26,1,3,2,2,8,2082450.04010061,5883043.55997471
0,11,2,1,0,3,6,1362038.54621545,3761486.12133795
0,35,1,2,1,0,4,1302965.88606458,4228223.68609921
1,11,2,0,2,3,7,1351540.25361853,4933865.95536278
0,11,2,3,0,0,5,1405490.38743076,2805530.13206721
1,14,6,3,0,1,10,1613035.8856009,5577474.87643682
0,25,0,3,2,0,5,1471304.35741348,3140082.11171367
1,21,5,0,1,1,7,2077716.93703861,8791122.55644282
0,14,4,2,1,3,10,2545054.00846098,3911705.01270441
0,23,0,0,2,6,8,1740891.08043249,4248678.05892011
0,37,1,1,0,2,4,952009.943913794,5605737.71717253
1,36,3,2,2,1,8,1888555.61383269,7006161.68798756
1,15,4,2,2,3,11,1823755.5422372,7045270.16156382
0,15,5,3,0,3,11,2213093.30683751,7922934.7955955
1,10,5,1,0,3,9,1918266.55734075,4975646.75871727
0,34,5,3,1,1,10,1751629.08902101,4781592.79476067
0,16,1,3,0,3,7,1434269.22533811,5508910.35507243
0,10,6,0,1,4,11,2150558.12422381,6630504.33831581
1,10,3,2,0,3,8,1554918.17766228,5917222.3403359
0,27,3,3,2,4,12,2225292.0017943,8166884.95326908
0,37,6,0,1,7,14,2000475.18964014,10984924.9655388
1,29,5,1,2,4,12,3263957.90488799,7188482.84794382
1,16,3,3,0,7,13,2478313.66914589,6778381.67663822
1,27,6,0,0,7,13,1689605.00481247,7193531.58312841
0,25,3,2,0,4,9,1452539.26860135,4775532.647048
0,13,6,0,2,1,9,1355690.50375822,5317498.03592377
0,28,0,0,2,6,8,1203037.34432475,3392131.87074705
0,35,1,1,1,0,3,1534412.26669235,2815359.56144397
1,28,0,1,1,6,8,1608514.42030721,4060668.2415472
1,15,2,2,1,2,7,1593080.01774357,4254945.32172529
1,26,5,0,0,0,5,1575881.67724579,4529348.37430076
0,19,3,0,1,3,7,1458299.96524741,3750231.55654259
1,22,2,0,0,4,6,1384505.94912374,4285044.46116883
1,23,3,1,1,5,10,1270566.94340568,4094699.04857782
0,17,6,0,1,6,13,2496225.58887851,6713685.07721502
0,19,4,1,0,1,6,1688593.54992372,2569465.67408263
1,28,5,0,1,4,10,2118458.46966156,4087749.222739
1,23,1,2,0,6,9,1893572.88202751,4404198.36905782
0,19,6,3,2,1,12,2349749.77917951,5874966.4817811
1,13,5,2,0,2,9,1787974.25753411,10828155.8620165
0,15,4,0,0,5,9,1862166.09588943,7919571.26690547
0,26,0,2,0,4,6,1621335.23307043,3974417.44866218
1,40,5,0,2,5,12,1940390.06274016,6541219.81856372
0,19,3,0,1,5,9,2660885.18045789,7847236.77252805
0,32,0,3,2,7,12,2643823.63409371,7207600.29557512
0,12,6,3,0,1,10,2549238.35624511,4707812.95889818
0,36,2,3,0,5,10,2252136.6509094,5335278.83688603
1,22,4,3,2,1,10,2159657.43255033,5488508.89058928
0,28,5,2,2,2,11,2549623.79900132,8064428.43204456
1,15,4,0,2,5,11,2450556.67349718,4056083.25981451
0,24,1,0,1,0,2,957551.249268544,5095091.28659123
0,40,2,2,1,0,5,1571001.68359913,7858977.11058158
0,23,6,0,2,7,15,2066787.73997585,7497341.76847292
0,21,4,2,0,0,6,1265740.72982891,3123443.14364109
0,17,0,1,1,0,2,1397515.13531974,3311154.3788767
0,13,1,1,1,2,5,1513996.09003287,3052178.62033856
0,10,2,3,1,7,13,2166620.72570336,5201841.0067655
1,17,3,1,1,6,11,1491657.82238739,7809460.2159026
0,19,1,1,1,7,10,1745518.54770977,5035580.19863023
1,12,3,1,2,5,11,1987161.35664647,5006524.13788462
0,19,6,0,1,0,7,1457503.81260246,6172365.55482251
0,27,2,3,2,1,8,1897957.13120497,247895.52318812
0,24,5,0,0,0,5,1784247.49310021,3294709.61724911
0,10,1,1,1,7,10,1867226.70588112,5897874.87261339
0,22,5,1,2,2,10,1960300.60841306,6891246.89445567
0,33,1,3,0,7,11,2036348.13977375,6905278.13364297
0,39,2,2,2,3,9,2076410.72599405,3072367.57995699
1,39,0,1,1,5,7,1722524.08797423,7679683.73145577
0,23,2,2,1,6,11,2276272.81744627,7250725.00587546
0,15,5,1,2,4,12,1996528.14753144,9016125.95712565
0,25,6,3,0,3,12,2975304.45044314,5790097.56814343
1,16,4,3,1,3,11,1881260.82221275,5551019.69020836
0,21,4,1,2,4,11,2159992.61798916,5949611.07803943
1,37,4,3,2,6,15,2888680.47574607,9120146.18410806
1,28,4,2,1,5,12,1840731.9009787,5502655.21501347
0,30,6,1,1,4,12,2640276.29885093,11254351.602819
0,27,3,2,0,2,7,1719731.67347099,3266209.21803999
0,35,2,2,1,7,12,2215572.9347841,4656736.43406403
0,28,1,2,1,4,8,2097015.94729912,4785987.14812646
1,15,5,0,2,5,12,1954798.09902968,6970474.42598775
1,19,5,2,1,1,9,1973539.47267617,4217519.23437461
0,20,2,1,2,5,10,1601286.66329884,5138445.80879577
0,22,1,3,1,6,11,2060587.22151675,7424390.27475521
1,38,2,2,1,3,8,1191697.74461293,9644202.15537011
1,33,5,3,0,6,14,2479013.97524144,6304110.2967986
1,22,1,2,2,6,11,2241121.33231231,6842654.77080546
0,10,0,0,1,3,4,1271365.49722503,3342197.38676941
1,24,4,0,2,6,12,2152528.22616706,8428934.09495027
1,37,0,2,0,3,5,1385448.22674269,2339421.32457336
0,22,1,2,0,2,5,1387208.29774803,5304327.13301337
1,15,6,2,2,5,15,2848708.05779356,12381966.6882144
0,29,5,3,2,6,16,2308437.57469489,5003281.03991488
1,31,0,3,2,7,12,2319477.38277652,7242474.50253479
1,13,3,1,0,3,7,1746796.16884162,5752383.54565854
0,37,6,0,0,3,9,1790396.49179985,4386386.66282502
1,39,5,1,0,2,8,2098245.63722115,5399168.66168848
0,15,4,0,0,7,11,1921720.42507344,6728677.80965951
0,30,2,2,2,0,6,1154384.30868412,3510035.33437491
1,14,2,3,2,1,8,1862991.14886668,8324301.09564722
0,11,4,3,0,1,8,2334372.2886646,9858089.82170247
0,31,6,0,1,1,8,1919326.57352198,7320632.94055651
0,32,3,3,2,5,13,2427791.49669772,7511454.02881375
0,12,6,3,2,5,16,2927482.0384044,10191188.7352407
1,13,3,0,0,6,9,1865234.75331768,9223541.1224514
0,25,3,1,2,4,10,1713617.42120797,4654075.83370079
0,18,2,2,1,5,10,1764230.31637518,6377413.36216669
0,40,3,3,1,0,7,1844060.20297644,2668953.99836936
0,34,3,1,2,5,11,1679353.04780317,7768481.54618481
1,30,2,1,1,7,11,2151467.61053927,4462787.05652604
1,36,6,0,0,4,10,2031975.16141252,5937883.28236662
0,10,2,0,0,5,7,1672050.12936356,4222141.85665517
1,29,3,2,0,1,6,1843552.35575476,7168581.02829868
1,26,0,0,1,1,2,1084340.22730042,4048747.82625875
0,25,3,0,0,4,7,1892122.55432338,5983304.10082748
0,38,2,1,0,0,3,1482891.63996677,2919771.28668574
0,28,4,3,0,7,14,3175328.02045575,6847213.46226779
0,19,5,0,1,4,10,2018610.2407734,3602329.13644283
0,10,0,3,0,0,3,1374474.00517557,4453779.22579738
0,38,4,1,1,0,6,2088015.13461459,5001799.26015836
0,17,4,1,1,1,7,1948099.55799186,5266824.56831817
1,28,6,2,0,6,14,2230585.28547186,5892090.28714325
0,14,4,2,1,3,10,1876783.84941434,8375347.43260005
1,25,1,1,0,5,7,1893506.77867979,5872728.79145142
0,32,0,0,2,4,6,1588649.85947178,3973496.42437628
1,20,0,3,0,6,9,1992533.28779939,7587619.45651043
0,20,5,0,0,7,12,1875021.5952233,4412437.70619782
1,33,0,2,0,0,2,1075212.12780009,2591435.51306321
0,30,1,2,1,7,11,1999319.74981968,7033815.49605576
0,18,3,2,1,1,7,1619652.44259658,7019451.15755505
1,39,0,0,2,4,6,1270864.26344107,6455559.66600843
1,14,1,2,1,2,6,2085004.9235095,5067267.85193075
0,37,5,3,2,7,17,3470916.40928876,4013750.65294089
1,16,4,0,2,3,9,2060571.480662,4326771.23951885
0,34,5,0,1,7,13,2533699.09953856,4476336.95238094
0,16,6,2,1,4,13,1935212.01147713,7375761.46867859
0,16,3,3,0,7,13,2222690.20951853,7538447.04136282
0,28,2,1,2,4,9,2242395.70905853,4176088.95347247
0,38,3,3,0,1,7,1580835.69479088,3955015.1476293
0,32,4,0,2,4,10,1991968.0820265,8068964.22983317
0,21,6,3,0,6,15,2788640.27907562,7531643.95193936
0,34,5,1,0,2,8,1452395.226656,7803934.42780599
0,38,5,2,2,3,12,2031510.28058297,5225340.79720576
1,14,1,0,1,6,8,1480828.11616469,5623545.29973448
1,18,6,2,2,5,15,2415754.82497975,3385740.60018679
0,14,1,3,1,7,12,2502009.72397608,7050952.92017325
0,24,2,2,2,1,7,1617517.76375122,5605187.57666797
0,14,0,3,1,2,6,1845514.73994575,4845713.49896661
0,34,3,3,2,0,8,1571734.01153867,4931521.51360684
0,34,3,2,2,3,10,1889447.23952962,7392498.93797911
1,17,2,0,1,1,4,1705981.37823607,2968159.48740059
0,22,5,3,1,4,13,2575495.72650599,6190511.30255513
0,29,2,0,1,2,5,1905109.65094484,4661619.48495803
0,11,6,2,2,1,11,2062222.75947747,8627842.98493294
0,16,0,1,1,6,8,1823841.50619891,3522837.04968273
1,11,4,3,2,3,12,2119140.95603021,6609995.23204971
1,13,0,3,2,3,8,2178844.59516984,6033471.93987231
0,15,1,0,1,6,8,2127955.40249844,5845490.8094602
0,31,1,0,1,0,2,1218452.41328488,4502996.40569189
1,14,5,0,1,5,11,1966513.53448839,8017031.48517333
0,19,2,1,0,3,6,1296588.08617245,4685141.68829595
0,38,4,2,1,3,10,2109915.84891115,6817218.40608431
1,30,3,1,0,4,8,1620783.04908511,5928179.41489136
1,37,3,1,0,0,4,1203014.50771858,5706775.80406677
0,26,2,1,0,5,8,1708351.90172728,6392852.90263083
1,18,6,1,1,1,9,2114681.31006478,5712724.9791162
0,20,4,2,1,4,11,1587525.17867625,7626263.93203174
0,14,3,0,1,0,4,1511066.88957216,4855006.8053004
0,26,4,1,2,7,14,2634557.12146869,5593163.75229067
0,12,3,3,0,4,10,2078904.78360406,5989543.67873272
0,23,2,2,0,4,8,1917096.07586736,7329908.29061237
1,13,1,1,2,3,7,1558223.43093896,3366534.83093091
1,25,4,1,1,7,13,2695709.12171136,4123677.29974211
0,20,5,3,0,1,9,1356008.381895,3012289.27961818
0,11,5,2,1,1,9,2011272.0111321,8419768.77107786
1,38,1,1,2,0,4,1434411.08220476,4735019.88720618
1,40,4,1,1,4,10,2044301.8177355,5221849.53455928
0,17,4,3,1,7,15,2601162.39201273,9378187.12358676
0,22,1,1,0,0,2,1427802.38525114,1561664.83119186
0,27,0,1,1,7,9,2140932.18405811,6392251.70121764
0,17,5,1,2,7,15,2729139.15419127,6530855.54210541
0,29,4,0,0,1,5,1459842.67205798,2360824.23657765
1,23,4,1,0,1,6,1122464.50537558,1595556.23434445
0,23,3,1,1,6,11,1706159.00100248,7301286.34202022
0,28,2,1,2,2,7,1373716.7796386,4427840.71945232
0,21,3,3,2,1,9,1567364.17801808,7076230.17984852
0,30,4,0,1,5,10,2078119.73540716,5682003.29311195
0,34,5,3,1,7,16,1589396.35030987,7336491.08582169
0,30,2,1,2,4,9,2168554.1379252,10008033.9193912
0,22,3,3,0,0,6,1892531.31292166,5175781.59113769
0,10,5,2,0,1,8,1782257.2939382,3281114.78677717
1,33,2,0,1,4,7,2013298.76621532,3777077.1772752
0,40,3,2,1,6,12,2465886.95394975,4174785.52455224
0,36,6,3,2,4,15,2345019.21785059,4686938.21881105
0,13,4,0,1,5,10,1764818.54393607,6987344.78647492
0,21,4,3,1,0,8,1969889.85577242,3933617.33506996
0,13,4,0,0,1,5,1288852.44311155,6692404.73968533
0,18,6,2,2,4,14,2796359.53541095,9673518.01354246
0,40,5,2,1,6,14,2262243.25268861,5894288.98232667
0,23,3,2,1,5,11,2455442.75399168,6626507.12181397
0,21,0,0,1,4,5,1426100.00960305,4116131.54014936
0,16,6,0,1,4,11,2427369.87693029,5905057.27273173
0,34,6,1,1,1,9,1757824.65708764,6939725.92049662
1,26,2,0,0,6,8,1649451.96605764,7266711.28220877
0,38,4,1,0,7,12,2433644.93612591,6138512.6393824
0,20,1,3,1,1,6,1639419.42254963,5853697.20273359
1,20,3,2,0,0,5,1226481.36478206,5608230.90427044
1,32,6,2,0,6,14,2020526.84339124,7781152.32670014
0,32,0,2,0,6,8,1602074.77757236,6030474.68356762
0,32,0,0,0,5,5,2039244.66891825,5172644.25902127
1,19,3,1,2,1,7,1813713.6739767,5085704.4498591
0,25,4,2,1,2,9,2710750.77660751,3577100.80719161
0,11,2,3,1,4,10,1782282.42691287,4137664.61951409
1,12,2,3,2,7,14,2955843.6690322,6590376.08521007
0,30,4,0,1,7,12,2226731.1739481,7197256.87439635
1,16,4,1,1,0,6,1400457.23717146,2360956.41564078
0,37,2,0,1,5,8,1379586.53621351,4754189.40843029
0,18,5,1,0,5,11,2291791.4120661,5602726.51857157
0,29,6,2,1,3,12,2646685.70106592,6822304.58834264
1,21,0,0,2,1,3,1237874.4280252,5121290.37188443
0,10,5,1,2,4,12,2220861.27732439,6842493.11462067
0,21,3,0,1,3,7,1823935.65856085,7843026.26343023
1,32,3,1,1,6,11,1730901.78429534,6905520.90317258
1,21,3,0,0,3,6,1655716.2716153,5634614.70829844
1,21,3,3,0,5,11,2229074.6502963,8209018.07937388
1,37,1,1,2,0,4,1255861.00695135,7734682.38425956
0,24,6,2,2,5,15,2278530.00113346,3809067.80535143
1,33,5,0,0,0,5,1444835.16520036,7640299.7986269
0,36,1,1,1,6,9,2281621.89216037,7106746.04010642
0,31,6,2,2,3,13,2609680.7089907,3350423.52014571
1,14,2,1,1,4,8,2581957.76325064,4236267.26093958
1,34,1,3,1,1,6,1782438.74252218,5287256.62454649
0,26,4,2,1,6,13,2728260.08568076,3801835.6837859
1,14,1,1,1,4,7,1724937.30375022,5832168.89653718
1,30,1,3,0,5,9,1902202.2895887,3150960.79273507
0,20,0,0,0,5,5,1362659.79288794,3855949.26313559
0,36,5,1,2,1,9,1751637.47873571,5404471.00201464
0,15,5,1,0,7,13,2094801.14358656,6701862.78567445
0,35,1,3,2,4,10,2364468.52604036,6493934.87716996
1,23,3,3,2,5,13,2777332.16083458,5412800.25609991
0,38,4,0,2,4,10,2278691.10178936,7615954.07044917
0,24,6,0,2,1,9,2015835.66946504,2102325.09217087
0,18,3,3,0,4,10,1822113.98633847,6621966.79800509
0,14,6,0,1,3,10,1545314.75826639,6452341.62636731
0,33,0,1,1,3,5,1559327.73850932,2361424.61587302
1,29,0,2,0,0,2,1422648.2600567,3808998.40654761
0,35,4,3,0,3,10,2130265.41669552,6870236.60034705
1,34,1,2,2,6,11,2368946.3984363,4871018.4861451
0,30,5,3,1,4,13,2064606.0017082,5826209.91760867
0,19,2,0,2,4,8,1409657.93769569,5949968.01376955
0,10,6,2,2,2,12,2924826.14889745,5382427.948782
1,30,0,1,0,2,3,1730001.02762728,4543726.81859449
1,14,3,1,2,1,7,1610187.65242434,7644253.42409111
0,25,6,0,0,4,10,2392737.66322297,5129730.05329597
1,24,1,0,2,5,8,1649438.42339878,5784553.73118489
0,31,6,3,0,5,14,1861618.73977233,7236658.91990247
0,38,3,1,2,6,12,2378765.92921601,5688901.49130666
0,17,3,1,0,5,9,1998132.72223954,4601301.55647461
0,23,3,3,0,2,8,2011868.02736849,4881774.6132134
0,31,3,1,0,2,6,1483889.56071158,5789128.51556721
1,13,1,0,2,2,5,1649893.63109545,1566062.55901256
1,36,2,1,1,0,4,1273471.4034442,4441548.37280746
0,31,6,0,1,5,12,2966117.12120214,8048022.26294591
0,31,3,0,2,2,7,1879708.97690575,4344466.56176212
0,11,4,0,0,6,10,1943178.46075256,7435473.94648094
1,14,0,0,2,4,6,1690042.51554428,5118122.78940731
0,19,3,3,1,1,8,1720678.74960851,5340302.45222561
1,32,3,0,0,4,7,1844081.77486482,5983225.03083708
0,13,1,1,0,0,2,1143255.30138252,1143255.30138252
1,29,5,2,0,1,8,1480930.20516969,4363768.72176655
0,15,6,2,2,4,14,2323191.44391779,6735861.36052139
1,16,3,0,0,5,8,1303671.63165657,5151758.76748146
0,18,1,0,0,3,4,1251829.97177962,3110888.21846633
0,13,2,3,1,0,6,1707518.25551005,4342695.64070101
0,21,5,2,1,6,14,2632426.04773375,6774645.49881968
1,35,5,2,2,5,14,2044429.19732232,8115564.41435559
0,26,5,1,2,3,11,2157676.80595284,6819663.81733796
1,31,2,0,0,6,8,1408054.84087017,6338827.90908395
0,25,2,0,2,4,8,2146885.34733234,3240483.58394051
0,39,4,3,1,0,8,2357638.97300674,4630106.26324062
0,10,2,1,1,4,8,1871346.98891657,5391312.53873586
1,19,4,1,0,4,9,1786725.3318557,6978847.14833039
0,27,5,0,1,7,13,1582804.21781425,6724210.64627418
0,15,1,3,2,2,8,2071793.27497283,3491000.86050006
0,17,1,2,2,6,11,2027620.43743077,3576226.94891607
1,13,3,3,1,5,12,1358388.06400178,6889289.32426289
0,36,3,0,1,1,5,1529640.42074274,3095279.79338607
1,15,1,1,1,1,4,1307988.64606621,3532908.32025865
1,29,2,3,0,1,6,1519991.98314799,5622123.57325435
0,19,0,2,0,6,8,2359608.84053445,4813304.5674827
1,18,6,3,1,4,14,2803582.69208308,9246659.05312276
0,28,0,0,2,3,5,1832509.40070578,4655410.59491914
0,21,6,1,1,7,15,2483268.48334091,10636512.3544262
1,12,6,1,0,5,12,3010928.30124894,6788902.18748283
1,38,4,0,2,5,11,2053774.40064682,2170764.79556572
1,17,6,2,2,6,16,3343357.48773863,6198688.72116088
1,13,3,3,1,7,14,2547496.61799041,7921234.89029801
0,11,5,0,2,6,13,2691269.00850357,3624582.24590425
0,30,1,0,1,7,9,2410196.68339368,6789557.1729589
0,15,2,3,2,3,10,2093766.91434271,6846189.90369006
0,23,5,3,2,4,14,2479016.7539332,9134432.26063756
1,17,3,1,1,6,11,1875065.7845332,5311750.88533507
0,14,0,2,2,5,9,1784208.79916224,9119690.53554217
1,22,3,1,0,4,8,1348185.72616441,4489790.20059445
1,15,6,2,0,5,13,2130158.10794108,8146816.91533732
0,37,6,1,1,3,11,2055489.05322446,5621182.71742973
0,10,5,2,1,1,9,1842230.49697183,7243834.4487215
0,25,5,1,1,2,9,1843467.99834428,3562642.78231503
0,12,4,3,1,7,15,2048251.03371505,8221265.32534745
1,32,6,1,0,1,8,1665668.90585624,5052659.1691405
0,29,3,2,0,1,6,1568578.19252341,4265261.58685186
1,29,1,2,1,5,9,2328562.26641773,3258650.25263714
0,30,5,3,2,3,13,2160960.25033859,4617131.97962446
1,31,3,3,2,6,14,2426685.61523553,6536122.57820464
1,38,2,2,2,1,7,1491606.14415952,6084307.90972392
1,16,0,0,1,0,1,1324275.79617373,4590882.97661878
0,25,4,1,0,4,9,1679927.07091153,2573295.6336633
1,21,2,0,2,3,7,1701615.08171939,6671582.2051423
1,24,0,2,0,3,5,1478647.25046045,3254450.92437357
0,18,1,1,2,4,8,2108846.23115457,6915971.60215916
1,28,0,0,1,2,3,1692314.0334571,3928480.20192224
0,36,1,1,1,4,7,1571770.34851407,5136396.98045378
0,31,3,3,1,2,9,1695882.94730841,2238211.19736848
0,30,3,0,2,1,6,1828012.71555081,3934643.90669062
1,23,6,0,0,0,6,1890977.06095721,5148617.54011459
1,24,2,1,0,7,10,1393346.08192865,6498014.02199887
0,22,5,0,1,5,11,2127197.69826511,8023508.59500531
0,19,0,2,0,6,8,2162781.07328099,5271946.54336385
0,27,5,0,2,6,13,2464134.0417783,4719809.3175777
0,12,1,2,0,3,6,2275686.09573166,5604406.38440371
1,23,4,0,0,0,4,1316511.20265824,2707364.6090355
0,40,4,1,0,7,12,2436969.55715186,3829117.59204575
0,30,2,1,1,4,8,1706421.70590123,5283518.06254035
0,16,4,1,2,5,12,1929005.23259279,6252820.16411825
1,35,1,0,2,0,3,1456733.94166038,3936363.07827166
0,22,3,2,2,5,12,2721997.66134074,8755166.39530554
1,21,2,0,2,3,7,1552286.2928823,3093446.96566826
1,27,6,2,0,1,9,1996167.17712429,3803475.33813568
0,37,2,3,2,1,8,1702390.53738298,5901185.8759228
0,30,4,0,1,3,8,1605012.59119446,6259110.67658428
1,37,1,0,1,3,5,1552787.22166651,4128610.81876492
0,35,1,1,2,2,6,1170351.91866871,4815751.50766721
0,36,2,2,2,2,8,1365198.99080375,7483729.82294587
0,28,1,0,0,4,5,1737291.01643902,5667913.74533956
0,11,3,1,1,2,7,1777502.83214955,6337855.19307285
1,30,2,0,1,3,6,1376948.1453758,3842286.89524337
1,18,6,0,2,3,11,2736674.13646624,6019040.75499631
1,29,1,0,0,0,1,856959.836224678,5788896.80579504
0,35,2,3,1,4,10,1654746.88872666,3748552.09822025
0,38,5,1,2,2,10,2513319.32290466,5562999.01689031
0,13,6,3,2,7,18,2357553.96358034,13823359.3776811
1,22,1,0,2,7,10,2140028.36252986,6155302.69636256
0,17,3,0,0,7,10,2504727.94671102,9677690.56053057
0,15,3,2,2,3,10,2205477.48538264,6169831.72806339
0,40,5,2,1,0,8,1639551.61738851,4683876.28434969
1,36,2,0,2,4,8,2009195.81395319,3929563.25957501
0,11,6,1,0,6,13,2950531.72429589,4799229.4526855
0,33,3,2,1,2,8,1446271.23135991,5960739.5620105
1,16,2,3,2,5,12,2694028.51588124,4955046.10177508
0,38,2,0,0,7,9,1530911.51344124,5484565.89170351
0,29,3,3,2,1,9,1741232.50519598,5055210.43887169
0,26,0,0,1,1,2,809558.004000918,3678042.55443174
0,20,1,3,1,4,9,2129031.89832256,7953740.59683552
1,37,3,1,2,2,8,1594986.5740149,2924725.50632014
1,38,5,0,2,5,12,2189831.64655017,7861265.05591009
0,20,6,0,0,6,12,2628685.04616639,7718754.75572279
0,36,4,2,0,7,13,1832369.9674425,4036161.67617852
0,35,0,0,0,4,4,1337676.80177546,5075666.19487535
0,14,1,2,2,3,8,1808490.69759943,2540357.42586651
0,31,4,0,2,3,9,2049776.12124713,5789474.70326836
0,33,3,2,0,7,12,1778322.48103269,6300410.27701926
0,37,2,2,1,2,7,1816976.09978656,5247978.89922997
0,38,0,2,0,3,5,1437257.95642399,5172778.56031359
0,18,3,0,0,1,4,1015284.57337247,3887944.34923321
0,35,5,1,0,7,13,2270551.48924743,6671715.0570642
0,36,3,3,2,6,14,2862922.94853073,9569491.14575182
1,29,2,2,2,3,9,2162255.5033532,8677580.30556616
0,17,0,1,2,4,7,2055612.77872398,4490203.11423079
0,22,5,3,2,6,16,3503167.43444184,4766294.64110588
0,39,0,2,2,7,11,1292164.41227345,5710718.44124071
1,15,4,0,1,1,6,1614353.66688825,3454335.72522949
1,21,6,3,1,2,12,1979648.10152372,5520618.93099436
1,40,5,2,2,7,16,2268064.89719402,5397508.89678639
0,26,3,2,1,4,10,2146220.62086235,9881995.14344271
1,13,3,0,2,7,12,1769826.5729845,8099675.95285827
0,13,6,1,0,1,8,1521263.27142769,7201106.33233527
0,25,1,1,0,0,2,1170380.83292211,1747749.19848532
0,17,4,1,1,2,8,1899597.74912428,3142907.26944592
0,35,2,1,0,4,7,1531525.02499942,4720833.89739363
0,36,3,0,2,1,6,1559681.23150402,6373169.96844955
0,20,1,0,1,2,4,1690873.83398221,5617432.96209985
0,32,4,0,1,7,12,2412730.33883466,7460064.42151938
0,27,2,2,1,6,11,2584707.90173443,6108437.45978225
0,31,1,0,2,4,7,2274292.44102233,7007185.46838651
0,18,5,1,1,0,7,1862372.40581515,3593135.5634318
1,21,2,2,1,7,12,2445443.20816851,6507902.4200403
1,38,0,2,0,6,8,2532001.84264858,5412725.37581288
0,18,3,0,1,4,8,2026609.07501933,5381360.78871042
0,17,5,1,1,2,9,1499231.15569293,6696052.71992151
1,24,0,1,2,5,8,1779614.64714048,5987061.92824604
0,34,0,0,0,3,3,1427229.67213411,4922708.90183241
0,15,6,0,1,0,7,1869036.13515812,5872064.86413696
0,36,5,3,0,6,14,2841156.4997774,8884820.2765643
0,35,6,0,1,5,12,1928018.283469,9461121.7844192
0,39,2,1,1,0,4,1429977.48940824,3646267.97275541
0,21,2,3,2,7,14,2500050.06170795,10642615.3931092
1,10,0,2,0,4,6,1432259.55884994,5486183.41936664
1,23,3,0,1,3,7,2024724.76055426,4192155.32857436
0,32,0,3,0,7,10,2128406.58253063,5792657.85495891
0,38,3,3,1,1,8,2090891.1679406,4328893.57191792
0,28,5,1,0,3,9,2347678.33676683,6762146.20329824
0,21,6,2,2,1,11,1823890.05356182,5992708.57858693
0,26,3,2,0,2,7,1638754.52613459,4397959.81293417
0,38,3,3,2,0,8,1189000.63872469,2967868.66796507
1,22,4,1,1,3,9,1845094.5313159,4261823.40533737
0,40,0,3,0,2,5,1595036.78743174,3789761.19676329
0,35,1,0,2,5,8,1781063.0787235,7773706.18123329
1,29,6,2,0,3,11,2651757.48114411,7259815.85831725
0,36,1,2,0,0,3,1636871.02725131,4752360.63634285
1,32,3,3,2,5,13,1494101.36598819,4319437.68816831
0,13,2,1,0,2,5,1414648.68183751,2727247.16936598
0,12,1,1,2,5,9,2121581.9507155,6899754.35552583
0,13,6,3,0,3,12,2259679.92847288,7036310.19758837
1,38,5,2,2,4,13,2303345.99716806,5595973.34466272
0,12,6,2,0,7,15,3483677.05436295,6507068.52497117
1,19,5,0,0,0,5,1607346.18588725,5728975.08716771
0,31,1,0,0,2,3,1288263.33858084,3945460.01930138
0,30,2,0,2,1,5,1819727.36921924,6709690.41189415
0,34,6,3,0,3,12,1825199.801437,5764334.51586599
0,21,3,1,1,5,10,2321593.99226851,7124029.17162174
0,10,0,2,2,6,10,1807353.5241376,4848772.70992174
1,29,6,3,0,6,15,2677893.91181656,10221211.3996199
1,22,6,3,1,2,12,1709994.18912212,5042384.77733544
0,28,3,1,0,2,6,1657654.8169295,4638172.84032998
1,35,4,0,2,6,12,1906738.99669478,10040824.0908385
1,25,1,2,0,2,5,1554756.23387843,3165252.92207123
0,31,4,0,2,6,12,2020854.71301221,2293243.36886417
0,16,3,0,1,1,5,1914604.3249321,2998185.98244562
1,19,6,1,2,4,13,2521387.38820451,7931975.36456637
0,30,1,0,1,6,8,1747721.29760936,7629484.1286795
0,30,6,1,1,4,12,1817458.02578781,7804277.53229192
0,31,4,2,0,1,7,2186157.00620996,4436357.80001776
0,24,2,0,0,7,9,1909073.34104256,5672182.41886414
0,37,0,1,1,6,8,1760807.63907608,6259191.00379272
0,13,3,0,2,7,12,2196816.86010742,6739799.32216023
0,23,6,1,2,4,13,2312199.91547034,5605359.13602688
0,32,2,1,0,3,6,1783768.59940571,3528110.05029163
0,11,3,3,1,0,7,1784003.89785538,4458134.40349327
0,20,4,3,2,6,15,2703133.18474307,5726615.89422235
0,12,5,0,0,1,6,1158384.86828701,5236714.02035606
0,25,5,1,2,5,13,1815011.45835357,6011625.02291548
0,39,1,1,1,1,4,892745.073330652,3249800.08515427
0,14,4,2,1,5,12,2221469.30926623,3468367.56447153
0,32,6,0,1,7,14,2422705.41759818,10642826.0840055
0,33,6,3,2,7,18,3245677.65046109,8898148.04105324
0,12,2,1,2,2,7,1746468.99349751,6052269.76410429
0,24,5,0,0,2,7,1754050.58843635,3981344.19380687
0,30,0,1,0,5,6,1475750.83593467,5351124.94785728
0,29,2,2,0,1,5,1791648.66131579,4222720.9636685
0,28,1,3,1,1,6,1888535.49258626,3799907.48038805
0,35,4,0,1,1,6,1526757.17056208,6022060.76026783
1,36,6,0,0,5,11,2137912.46643818,8380662.09537173
0,40,2,2,0,3,7,1418428.07680379,4992577.81519171
0,26,2,1,2,2,7,1466678.8026271,7811287.77072765
0,29,2,0,2,3,7,2188494.36132848,5909611.37200235
0,27,2,2,0,0,4,1645892.58008541,2145444.75137133
0,39,4,1,1,5,11,2362845.18785352,7128078.07108095
0,10,3,0,2,7,12,2209549.37737319,2611484.69416449
0,15,6,3,2,1,12,2086942.89173854,3628310.11337813
0,29,0,1,2,2,5,1445817.65606082,4280492.35683016
0,22,5,2,0,2,9,1859973.85608527,6288188.41302151
0,25,5,1,1,7,14,2730606.34432872,8688750.04220264
1,12,2,0,0,1,3,1127599.87166188,3423476.5325975
0,14,2,3,2,6,13,2274204.85082705,8176457.02243861
0,31,0,2,0,0,2,1110988.76455935,4827216.37933059
0,17,1,0,2,6,9,2030893.74332404,6531860.0305826
1,21,3,3,2,7,15,2556066.03265683,8615172.19299796
1,37,6,1,0,2,9,1702891.20776825,6093450.87279909
0,24,4,3,2,5,14,1781022.1474345,10252964.5288215
0,28,4,1,1,3,9,1758233.58746931,5674413.00437396
1,16,3,3,2,5,13,1970084.57009468,8469678.89756816
0,20,3,3,2,0,8,1674559.99017732,5283481.075454
0,21,5,2,2,2,11,2054717.25262317,6474506.4955563
0,11,4,3,2,7,16,2931155.20166278,9157409.52871942
0,11,6,1,1,3,11,2271551.55268467,5114790.69257892
1,23,2,1,1,2,6,1869391.1561758,2598004.50689596
0,10,4,1,2,1,8,1482880.07067246,4985810.85808131
0,31,2,1,2,5,10,1998501.33536412,9044518.9057062
0,40,3,1,0,0,4,1608233.93820873,3496984.86918812
0,36,1,1,2,0,4,1452789.31737434,4610416.14484358
0,34,3,3,0,2,8,2130571.02926835,5020560.57240056
0,13,6,3,1,0,10,2164799.78358788,8110691.86921589
0,26,2,2,1,5,10,2352477.11559066,7625181.41262547
0,26,5,2,2,3,12,2331026.00330443,6146188.99819322
0,29,6,1,2,5,14,2363187.50701491,9418526.85509698
0,33,4,0,0,3,7,1692797.9125271,5653340.84297292
0,31,1,3,2,5,11,2392117.46870942,7251790.08625329
0,28,1,0,2,1,4,1461234.27018718,4400693.48507505
0,16,1,2,1,6,10,1978416.67907766,7632687.62345553
0,25,4,3,1,1,9,2301788.58531287,4560891.95892793
0,16,1,0,2,6,9,1649442.52648748,6628311.57556519
0,20,2,2,0,1,5,1736854.56323436,6159212.38135497
1,12,0,1,0,2,3,1541962.33439669,4812971.90577127
0,16,4,3,0,5,12,1887482.88097161,5595100.87651101
0,32,1,2,1,7,11,2404450.02639588,722402.53013554
0,26,2,2,0,2,6,1399570.39264586,4256423.89294251
0,33,3,3,2,4,12,1404385.54338372,8842181.40751227
0,26,6,0,2,2,10,2269631.85104193,6044020.43575142
0,35,4,1,1,4,10,1656263.87388954,3689291.43915559
0,24,4,0,2,0,6,1692817.57317019,4430335.21948066
0,38,3,2,2,1,8,1786190.12718122,4238551.03092103
0,10,1,3,2,2,8,2081381.38155678,5605772.93536644
0,12,5,2,1,4,12,2031354.99775576,6756139.34236522
1,32,1,3,2,1,7,1841521.10721075,3609900.27837944
0,19,4,0,2,4,10,1995799.66998551,4394651.16345382
1,32,0,1,1,6,8,1833145.92383302,5582858.42327228
0,40,3,3,1,4,11,1907200.68949774,6398383.93950207
0,27,2,1,2,5,10,1998485.27476614,5382808.13728429
0,31,3,1,0,0,4,1413079.55501157,5909984.64022375
0,24,5,3,1,6,15,2594792.34490361,5971607.32662078
0,10,0,0,0,2,2,1007771.96377071,3877163.89870087
1,22,1,0,1,2,4,1258000.98994997,5021410.6664337
1,29,4,0,0,5,9,2059856.32128323,4112686.80133093
0,27,3,2,1,4,10,1967824.38888193,7107203.04974575
1,17,5,2,0,1,8,1762084.02339265,5336070.88997895
1,31,5,0,2,0,7,1512664.97385241,3851237.01746703
0,13,4,1,1,7,13,1986168.17274218,4922313.12439364
0,29,4,2,0,6,12,2070507.20180164,7942790.11598712
0,36,6,2,1,2,11,2307002.40675582,7684903.35839199
0,26,4,3,0,4,11,2608101.65358927,8465724.00330041
0,14,6,3,2,5,16,3525087.33568053,5607811.81553994
0,15,6,2,2,2,12,1981377.83481224,5479899.7936087
0,16,4,1,2,7,14,1922780.17362489,10468254.3707013
0,29,4,0,2,2,8,2045426.87081891,4895076.57626482
0,11,4,0,2,4,10,2130312.50344437,2767921.8078155
0,24,1,0,0,3,4,1363377.91926551,4438477.25959868
0,38,0,2,0,0,2,1116782.00187496,3517549.54520251
0,11,0,0,0,1,1,981220.599072385,6370157.4549244
0,39,1,1,2,4,8,1532612.40538906,3995100.57969952
1,21,6,1,2,2,11,1933068.21325336,4634145.86482085
0,14,5,1,0,6,12,2095934.62971381,9078562.11422198
0,16,2,3,0,4,9,2109800.2498781,7358097.56082907
0,36,1,2,1,3,7,2118066.09812461,6111714.72293503
1,10,2,1,1,2,6,2270956.67428268,4936601.43854387
1,22,2,1,0,7,10,1488365.35689062,7070147.45781643
0,25,3,2,1,1,7,1819061.92103596,5829558.92938573
0,10,1,2,1,1,5,1697631.97175362,5697277.01197981
1,29,4,1,1,5,11,2554016.00875105,6636452.03019983
1,18,3,3,1,7,14,2370698.58609328,7190747.06404046
1,30,3,2,1,1,7,1982431.25392842,7897545.08014389
0,31,6,0,2,2,10,2031545.39492132,6544960.81165473
0,34,0,1,2,6,9,2018475.33745068,6380689.70556444
1,35,0,0,2,0,2,1244050.64889825,4385949.48423326
0,12,1,3,1,3,8,2035523.50358149,6817886.92329844
1,28,6,3,0,7,16,3105289.04187151,8606071.30345904
1,20,5,1,2,6,14,2049201.21109445,5484770.29604823
0,37,5,3,2,5,15,2225261.93007692,2353651.01385914
1,39,3,0,1,2,6,1797272.21524685,4525522.18514008
0,32,5,2,1,4,12,2064530.55714592,6685262.86317277
1,27,3,1,1,3,8,2355354.40734405,4152055.42517981
0,24,1,3,1,3,8,1623734.42943088,7457442.35391732
0,21,5,2,0,3,10,2121615.9563265,6495813.0325047
0,28,1,0,0,0,1,868227.689191156,6145200.36516624
0,40,4,0,2,6,12,2538023.43444698,6285814.71626334
1,32,0,3,1,7,11,2122589.32957929,5993933.41843942
0,28,0,0,1,0,1,1058952.82284727,3034624.19190506
1,23,5,0,2,5,12,1926290.16481999,3186189.60546742
1,20,1,3,0,4,8,1680116.19292944,3461744.41601296
1,11,5,3,0,4,12,2327292.14405197,3900316.19935936
0,28,6,0,2,0,8,1660259.76746055,5258254.65491256
1,19,4,2,2,6,14,2779570.41925147,7788632.63238973
0,11,4,3,2,6,15,2555935.00776689,4559467.42047058
0,21,2,1,1,2,6,1707325.2858854,2630189.69925652
0,33,2,0,0,0,2,1275245.73420764,5539833.60154646
0,15,3,0,1,0,4,1498208.72383932,5623049.13190219
1,20,6,3,0,5,14,2057336.27872874,9718987.38221432
0,40,5,2,2,6,15,3126191.63743111,10078609.127228
0,25,6,3,1,7,17,2137865.32063709,11954328.7475719
0,40,0,0,0,4,4,1506698.1682184,5194015.02809333
0,29,1,3,1,0,5,1197307.5283707,4180426.62104694
0,29,6,2,0,1,9,1985729.46579669,5901196.53523036
0,38,2,1,0,2,5,1258426.92734878,5573961.67121252
0,38,3,2,2,4,11,2161274.6126266,3633911.79537163
0,33,3,3,1,0,7,1994611.0603151,6364474.17629923
1,36,4,0,0,7,11,2286068.65099137,5465653.28464787
0,17,4,0,0,7,11,2095653.76059323,4783838.02113497
1,20,6,0,2,4,12,2771692.82088557,6893266.58880643
0,16,5,1,1,5,12,2415362.37298719,6840969.63643784
1,13,4,3,2,1,10,2730602.08647162,9171624.66757595
0,30,6,2,0,7,15,2611995.51059993,5987513.45764472
0,26,5,1,1,6,13,2272545.70608779,6515096.48967395
0,13,4,0,1,1,6,1780506.41088136,2278756.58010939
0,31,6,2,1,1,10,3043447.26075764,5045158.27236469
0,15,0,0,0,5,5,1390262.9114811,5403113.04449153
1,37,6,0,2,3,11,2427085.72022065,4102451.3879394
0,36,5,3,2,0,10,2189046.03389564,6094975.99037091
1,10,3,2,2,6,13,2808852.09731727,5512796.72027802
0,27,5,2,1,6,14,3176249.68521861,9002918.87016686
1,12,1,0,1,4,6,1283779.75578727,3686776.4250249
0,23,4,3,1,3,11,1753953.19016058,7282616.65383091
1,15,1,2,0,7,10,2491818.49761345,5516224.19290663
0,27,5,1,1,0,7,1753844.84882986,4470947.57853067
0,22,1,0,0,6,7,1665061.58720967,5033445.41217012
0,34,6,2,2,1,11,2302477.98671432,7178443.89197941
0,11,0,3,1,3,7,1546265.1131883,4201016.99459311
1,10,6,0,2,1,9,1813911.44239168,4379661.32879452
0,40,3,0,2,3,8,1797724.81314434,6953232.73119722
0,19,3,2,2,1,8,1772714.91067866,6302441.79437747
0,37,1,1,2,2,6,1570957.14368854,6017018.88227806
0,13,3,1,2,3,9,2037970.34387928,10599531.8458064
0,32,3,2,0,4,9,1669117.96236889,6210193.55222234
1,14,6,2,1,6,15,1748528.55339339,11100786.2301975
0,17,2,2,0,1,5,1558635.87480548,5482847.8419549
1,23,0,0,1,5,6,1583637.60076825,4048649.61667962
0,32,0,2,0,2,4,1036294.28053814,6172031.56246959
0,34,4,2,0,2,8,1869041.97060668,6538421.92493729
0,36,4,3,2,4,13,1733482.00811459,6977032.00515237
0,36,0,0,0,6,6,1580409.41680964,4229150.81173054
0,32,5,0,2,1,8,2016289.76537129,6657041.20385988
0,19,1,1,1,2,5,1624579.72232504,1141260.34375285
0,10,5,3,1,4,13,1624613.9670392,5111972.83848048
0,28,2,1,0,4,7,1680809.72680414,4748238.04149468
0,23,4,2,0,0,6,1699561.01234896,4030548.25087453
0,36,1,0,1,7,9,2187484.66769452,6521636.14932722
0,29,5,2,2,0,9,2421105.44284684,4447632.47955879
1,14,1,3,1,2,7,1670788.99920112,4264326.60780324
1,16,5,1,0,5,11,2151104.98680881,7987281.25262625
1,29,0,1,0,1,2,1105721.43934927,2199491.36332633
0,13,1,0,2,1,4,1522703.73149444,3670334.69201064
1,20,6,3,0,6,15,2298998.026305,5051023.63526837
0,11,3,1,0,4,8,2020272.02445184,5172097.32992297
0,28,4,2,2,6,14,2405184.22266048,8725161.07020442
0,12,5,3,1,1,10,2830073.25393406,3318670.54381545
0,34,6,1,2,5,14,2126031.57415336,7999696.78716061
0,16,2,3,1,6,12,2039967.24331548,7790378.55332339
1,11,1,1,0,7,9,1749821.8144088,4473994.99189657
1,20,5,0,1,6,12,2059041.2405888,4301786.40934388
0,34,2,3,1,0,6,2004882.78373715,4509401.21465969
0,29,5,1,0,2,8,2161277.51004867,7612720.59484849
1,26,0,0,2,1,3,1506371.76808484,4114303.06123383
1,30,3,2,2,2,9,2053474.10991222,5239613.24655341
0,21,2,1,2,6,11,1428650.55455534,8593575.36371622
0,24,5,3,1,2,11,2164535.84345039,3448446.76332717
0,17,3,2,1,5,11,1991847.11338489,6626263.79755695
1,39,1,0,0,3,4,1427688.68790076,4107826.32558899
1,31,0,3,1,4,8,2426357.28182228,3965854.53337556
0,21,6,1,1,6,14,1340682.63725521,10205716.4421117
0,18,6,3,0,6,15,2734226.2830142,12267829.3248335
0,19,0,2,2,4,8,1274308.97226455,6932519.56689972
0,37,4,0,1,6,11,2060645.13115765,5412982.50135934
0,22,0,3,0,2,5,1638541.24362848,3794064.22552254
0,17,0,2,0,0,2,1253842.06048588,2359679.03146145
1,39,1,2,1,3,7,1649216.06047743,7584512.51956449
0,30,3,0,1,3,7,1610773.73728752,1818525.91405795
1,10,5,3,1,3,12,3097650.99529857,6403479.15179211
0,31,3,1,1,0,5,1703797.13848069,1211430.63679295
1,30,5,2,0,2,9,1722518.73427165,6105194.70274277
1,19,0,1,0,7,8,1842370.12378952,4895350.79870925
0,20,2,2,1,7,12,2099925.54419535,8100293.66230778
0,21,3,3,0,7,13,2531778.53605846,9724683.98861601
0,34,4,0,0,4,8,2288318.84392893,5008238.12916871
0,35,1,3,1,1,6,1330930.49706981,3940114.5881567
0,10,5,1,1,3,10,1902846.78529705,3428288.21411269
1,36,4,0,0,2,6,1726578.34881619,2879716.11663485
1,38,5,1,1,1,8,1425497.00709621,4558138.7988592
0,32,6,3,2,2,13,1834370.66132401,8910848.58381855
1,39,4,2,1,6,13,2744104.48854547,7203462.4648201
1,31,2,2,0,2,6,1368878.14859068,7663186.15788025
0,31,2,3,1,6,12,1840084.04690996,3516625.73322886
0,34,2,2,0,1,5,1622081.80867779,5561666.42677164
0,17,1,3,0,6,10,1654688.59050124,3098387.01257125
1,25,6,3,0,5,14,2200506.86989837,8767615.99169687
0,25,1,1,0,3,5,913568.93845943,3293964.1088137
0,13,2,1,2,7,12,2436865.54825286,7689806.5439789
0,26,4,2,0,4,10,1582541.1735432,3919540.45099031
0,19,5,3,0,0,8,1744818.3184271,2360276.53506826
1,14,6,1,2,3,12,1515670.07996189,3570780.44139539
0,23,4,0,0,3,7,1709561.49597357,4658433.91682616
0,22,0,1,0,6,7,1565094.68339068,3515709.93319535
0,20,5,0,2,4,11,1841989.51521289,5371390.27155724
0,11,1,1,0,4,6,1357486.29513076,3793212.11591265
1,19,2,3,2,3,10,2140257.19826751,3373877.16025067
1,11,2,2,2,0,6,2056974.13633262,6181097.56336416
0,26,6,2,1,7,16,2467283.3607108,6635182.44493694
0,35,0,3,2,2,7,1557562.31011882,5204032.95549786
0,32,1,1,2,3,7,1886333.16327806,2991286.68768482
1,17,4,0,1,5,10,2007689.50316232,9599950.25322175
1,39,6,1,2,4,13,1817152.42319846,9444309.10784178
0,14,4,2,0,3,9,1762679.56161733,5900880.74991406
1,14,0,3,0,0,3,946657.377102285,3279224.4237313
0,11,1,1,1,4,7,1428896.35610332,3497520.71977985
0,23,1,3,1,7,12,1979908.60375276,6567009.92923806
1,38,3,2,2,4,11,2655759.95545342,6245161.79169206
0,37,3,1,0,5,9,2080274.60816286,6168531.38745808
1,40,2,2,1,1,6,1810941.34908091,6005237.94658186
1,13,3,3,0,1,7,1622063.18114948,587393.519114632
0,35,1,3,1,2,7,1965905.70651363,5143621.53360177
0,22,6,1,0,5,12,1859444.5295736,4663817.98251127
0,22,1,1,0,3,5,1031388.59537726,6363416.43570977
0,33,6,2,1,4,13,2719713.80492648,8526242.46002341
0,37,5,2,2,3,12,2730452.58637376,6524606.6978618
0,28,1,1,0,1,3,1263822.99936067,4734229.26688199
0,32,6,1,1,6,14,2324574.23474033,10787216.6880008
0,25,4,0,0,6,10,1880605.02569429,5250406.46575422
0,12,5,3,1,7,16,2751521.84687071,3623265.30204409
0,25,5,2,1,5,13,2834995.96697295,7711227.63893268
0,28,3,2,1,6,12,2347208.73747617,5462602.08628427
0,39,6,0,0,3,9,2113169.72365455,5182942.57401485
1,29,6,3,1,2,12,2107176.59984797,3885599.322105
1,22,3,2,2,5,12,2105528.38898579,7046079.79231405
0,13,5,0,1,3,9,2289626.49469458,5031478.94814761
0,17,3,0,0,5,8,2035063.09268969,7084508.61985148
0,14,0,3,2,4,9,2458657.60586287,7910065.2134841
0,39,1,2,2,5,10,2075034.07034278,7730462.4828127
0,22,1,3,2,3,9,1946839.50859961,3995184.15440636
1,29,4,2,1,5,12,2581278.00293146,5616960.76260332
0,33,2,3,2,6,13,2109071.00609699,4591747.86319583
0,11,3,1,1,7,12,2577809.12140136,7338125.37952738
0,38,6,3,0,5,14,3018645.46054303,6806780.65418216
1,39,0,3,0,5,8,1743291.15710456,1603271.31638765
0,40,1,2,0,7,10,2613132.83996883,6537693.51134259
0,35,1,3,1,3,8,1897015.24179517,2764744.15497785
1,24,5,1,0,7,13,2230967.5877438,7394619.38990401
0,33,3,3,2,6,14,3693184.43121719,4689274.02144829
0,27,5,2,0,1,8,1843907.12250315,8117239.97602148
1,29,6,1,1,2,10,1809560.48341057,6571591.86067566
0,21,6,1,1,2,10,1914032.13891509,7708604.00041037
0,18,6,3,2,3,14,2418952.24161245,3525802.70480972
0,18,0,3,1,3,7,1370044.32778615,4605775.2167277
0,32,6,1,1,0,8,1902845.37522861,3730140.5362563
0,29,6,1,2,2,11,1897391.19998188,5726758.47326959
1,15,3,2,0,6,11,1809360.01756744,4766170.34441115
1,12,4,3,0,1,8,1734230.64774695,5164512.21370398
0,36,3,3,1,7,14,2926933.25786108,10327975.7093806
0,28,1,3,1,3,8,1765783.35076061,6229741.50975918
0,21,1,3,1,6,11,1762636.26850207,8495718.20739296
1,36,0,2,0,1,3,1426393.67633443,4396784.45180078
0,12,3,1,0,0,4,1657176.42156146,4376254.21689767
0,27,0,0,1,4,5,1540080.5805394,5993715.00614718
1,32,1,0,2,2,5,1814141.57604971,4016654.74831877
0,21,5,1,0,3,9,1897252.07859951,5863638.21130694
1,40,4,1,1,5,11,3131907.48637933,7947295.16496853
0,40,2,2,2,4,10,1410837.37234331,4851544.02418706
0,32,3,0,0,2,5,1575077.12230739,4103643.54638403
0,12,6,0,2,5,13,2916488.21837294,5489195.79964213
0,39,4,0,2,4,10,1929122.92567189,6345362.96771232
0,37,0,3,0,0,3,1357338.91307233,3699096.32043973
0,10,5,0,2,0,7,1732128.34921191,2793428.12695962
0,12,0,0,1,3,4,1429391.63428983,5348155.99505205
0,27,5,3,2,7,17,2956675.66800352,9424500.84252931
0,19,2,1,0,3,6,1877271.55918535,5951348.21119874
0,16,2,0,2,5,9,1989383.357517,6056650.56628647
0,16,6,3,2,6,17,3481957.97787951,7146291.02161249
1,36,5,3,2,5,15,3102262.35924162,10413693.8754007
0,14,6,0,0,3,9,2081290.31742281,3499515.99449258
0,18,3,1,0,7,11,2092711.42097733,5028378.58431244
0,22,2,3,0,2,7,1437097.33041761,2622413.48585821
0,21,5,1,2,2,10,1558462.43043934,3403091.81977009
0,11,3,0,2,3,8,2380568.86513981,5824395.85858878
0,19,2,2,1,0,5,1456606.56695762,4648993.92737245
0,16,0,2,1,6,9,2554924.96554608,2540448.94053642
0,23,0,0,2,2,4,1437933.307457,4522825.11923089
0,20,6,1,0,6,13,2651792.7504653,5277092.80726624
0,30,4,1,2,0,7,1964357.40834359,2478415.94692985
0,24,2,1,2,1,6,1647000.06573486,4928037.77227965
0,16,2,0,1,0,3,1132372.27625073,1338167.45333625
0,32,5,1,2,1,9,1935919.72917087,4462159.01946026
0,31,4,2,0,1,7,1964445.82481269,5459972.00363925
0,13,6,2,1,4,13,2140826.80233948,2922042.65698081
0,35,0,0,1,7,8,1972908.51300095,8207713.31768748
1,19,2,0,1,7,10,2333099.40513666,8276524.49321773
0,18,5,3,0,3,11,1806351.51303187,6506716.24276189
0,22,0,1,2,6,9,2193442.09354525,5779377.56894867
1,11,1,2,2,7,12,2411581.75506097,8090920.02665707
0,11,4,3,1,3,11,2053001.42219174,6320901.80169944
0,20,6,1,0,1,8,2255794.48298654,2937249.79166032
0,38,4,1,2,7,14,2743733.68595116,7456985.68037137
0,34,0,0,0,0,0,1100990.13475628,2587764.89002402
0,18,4,0,1,4,9,1630066.40736966,5609296.90664731
0,39,3,3,0,4,10,2184946.64961779,5412548.47025069
1,17,6,3,1,3,13,2424362.80599844,4650202.71698731
1,12,3,2,1,2,8,1705663.43957144,4565520.83436984
0,12,0,3,2,7,12,2535824.47727494,6079202.44843469
1,11,1,1,2,6,10,2212393.27176281,2332514.53112382
0,12,0,3,0,7,10,2469762.5837493,4386738.17199797
0,38,2,1,2,1,6,1687225.35592869,5681114.65576008
1,35,5,3,2,5,15,2649933.99575199,7383031.35303238
1,23,2,3,0,1,6,1496380.44523368,4444199.15333584
1,19,5,0,2,5,12,2326530.02199759,8716701.08757538
1,32,0,1,1,4,6,1718759.94613929,6337417.36454664
0,18,5,1,1,0,7,1615905.632466,1401931.4684311
0,29,5,3,2,1,11,2120743.78218852,4109604.69927348
0,39,6,3,2,7,18,2403589.52497397,7665350.53985499
0,34,0,1,2,3,6,2047036.71821108,5565586.69860426
0,16,6,3,1,0,10,2224742.57553045,4608816.04581938
0,37,1,3,2,2,8,2083624.38243902,6221604.59179368
0,28,5,1,2,4,12,2252044.36570189,8081826.97819983
0,31,6,1,2,5,14,2511103.11482634,9341669.08823517
0,27,6,3,0,0,9,2034956.40582485,5785575.25761942
0,20,5,2,0,5,12,1786079.47062861,6460655.40651082
0,34,2,3,2,7,14,1963877.42710799,3963373.3844962
1,38,4,3,2,7,16,2475227.93897615,10174975.5149877
1,38,6,3,0,1,10,2184365.3177536,6607445.89494143
0,33,6,1,2,2,11,1716305.33043591,5630341.33383901
1,10,6,3,2,3,14,2345010.00220626,5606365.24200492
0,23,1,1,0,7,9,1060948.37230786,5419881.80646933
0,17,5,0,2,1,8,1612093.93731883,8235130.26449024
0,20,5,2,0,7,14,2628287.70026527,13108805.9164832
0,27,1,1,2,2,6,1605665.10346749,4117048.45102774
1,23,4,1,1,4,10,2101261.7647043,5742621.79718905
0,29,4,1,2,1,8,1880207.90749796,4995178.46988223
0,27,0,3,2,4,9,2065116.73769146,3913451.49667462
0,19,2,1,1,0,4,1127451.40248589,4574611.97888639
1,31,6,1,0,3,10,1175762.38377752,6794914.65095907
1,23,4,0,2,5,11,2224547.98499921,5058285.688379
0,27,6,1,1,7,15,2273233.66108859,7209999.58762661
0,14,3,3,0,4,10,1738440.40613293,3780160.09310577
0,12,6,0,2,1,9,2644941.85407498,5491989.33843265
1,22,5,0,1,7,13,2138724.18120693,7688303.86205146
1,39,2,1,1,4,8,1938928.58521612,6392496.17522928
0,17,1,0,2,2,5,1548994.26960809,4493146.22376677
0,36,4,0,0,0,4,1132134.18391633,4673693.44396281
0,30,5,2,2,0,9,1823823.52163843,6537842.20594239
0,30,1,0,0,7,8,2070914.51260189,3700513.24079078
0,27,0,3,2,1,6,1835831.43661408,7575088.18434782
0,39,2,0,1,6,9,1949246.26923235,5839431.31127241
1,11,1,3,0,0,4,984002.903734914,4103015.9852169
0,28,3,2,2,1,8,1953160.35224994,6436521.56368464
0,21,6,2,0,4,12,2274436.85650138,5657608.02116883
0,12,5,2,0,1,8,1829349.59992987,4725307.29697988
1,25,4,0,1,7,12,2429303.7754441,7155610.10438373
0,28,0,2,0,6,8,2017255.86301706,5970612.76285694
1,26,4,1,0,2,7,1228645.00588904,5306672.23565811
0,16,0,2,0,1,3,1307568.84545856,5355475.43484895
1,10,0,0,2,1,3,1208668.418464,5422367.08996486
0,13,2,3,1,7,13,2427477.23014855,7605891.71246885
0,15,3,1,2,7,13,2451541.07233127,9661737.52163886
0,34,6,3,2,1,12,1660679.91296733,5304987.70981324
1,26,1,0,1,7,9,1573432.9306593,4751935.39685908
0,20,6,1,2,4,13,2647404.0842984,8227026.0380521
0,14,2,3,2,6,13,2369776.79799008,6734521.82396657
1,40,4,0,1,6,11,1903983.89583956,3572787.74370744
0,40,5,3,1,4,13,1883909.32706336,6918055.14042707
1,28,6,2,0,5,13,2017873.28729112,7280517.38135428
0,19,4,2,1,7,14,1390271.99576914,10588519.9675603
0,22,0,3,1,0,4,786779.279904363,6642184.17352072
0,20,1,3,2,1,7,1569968.14445834,2998651.40370246
0,21,3,1,1,5,10,1320399.15022142,6540783.17794338
1,29,3,1,2,6,12,2091481.02470146,5212562.88796788
0,37,6,1,1,5,13,2305754.1397568,6422815.55102785
0,16,0,0,1,4,5,1394229.28030928,5702843.74350693
0,35,6,1,1,0,8,1760650.75918685,4116486.03984499
1,31,6,0,2,7,15,2029703.20118411,9674298.10928907
0,14,0,0,2,1,3,1320061.69733783,5568274.8632885
0,27,5,1,2,3,11,2114808.89227687,4869103.30119705
1,15,0,2,1,1,4,1487986.75596277,7203398.19294521
1,10,4,2,0,2,8,1663636.61477307,7129795.86752826
0,14,5,2,2,3,12,2578735.94068981,6988260.11174604
0,28,5,1,0,2,8,2065375.61756842,4948794.85400139
0,12,5,1,0,1,7,2041378.45157081,7271853.77055181
0,18,0,2,2,0,4,1211481.74124841,2033165.15796994
0,28,4,3,1,4,12,2711493.87229379,5990726.41504956
1,17,5,1,0,0,6,1483105.71426584,6078731.24384388
0,29,1,0,1,0,2,1446198.36420008,2792511.98603308
0,15,1,2,0,2,5,1197563.8141284,5098501.99027646
0,13,3,0,2,2,7,2031330.60917578,6307248.210072
0,19,0,1,2,2,5,1532896.30494505,5244988.45735144
0,11,4,1,1,2,8,1853815.33965952,7215442.92357209
0,15,3,0,2,3,8,1823674.28810323,4483698.949415
0,35,5,2,1,1,9,2311109.47607122,6336462.17242843
0,21,0,3,2,6,11,1691641.50357663,5896783.86723179
1,37,3,0,2,7,12,2533295.22382404,7551943.51137248
1,28,2,3,0,1,6,2077805.32878605,3947766.54716922
1,20,2,1,2,0,5,1794939.9200813,4687403.66215754
1,23,6,3,2,4,15,2907251.62828893,3441117.16702432
1,29,5,2,1,5,13,2370862.52319086,7854661.27495988
0,29,1,1,2,1,5,1073138.43683228,5908745.79479699
1,17,4,2,0,0,6,2011890.28523761,4342428.08207087
0,24,4,3,0,1,8,2325574.96986724,6215921.21438055
0,38,6,2,1,2,11,2325397.04882313,4601049.59695015
0,15,6,3,1,2,12,2561060.16311656,6351943.45790981
0,28,2,2,1,4,9,1897915.16287268,3476719.94669372
0,36,1,3,1,7,12,2476951.95013848,12244055.5485306
0,38,6,0,2,6,14,2457311.94010187,5001213.44882798
1,17,3,2,1,2,8,1861476.98963202,2387340.72098049
0,16,2,1,2,1,6,1364970.22699005,5038025.53596602
0,10,1,2,2,1,6,1913091.39660947,3409176.82780774
1,13,2,2,2,2,8,1807316.68993259,3414799.00669328
0,37,1,0,0,3,4,1377583.14579819,3808202.49328576
0,18,4,0,2,0,6,1768226.96818894,7171451.66724515
0,12,3,1,0,4,8,2315145.49777689,8894250.85144714
0,28,5,2,2,0,9,1663141.91859898,7903952.48545358
0,14,3,1,1,3,8,2029162.08539922,5644248.48683283
0,33,1,3,1,0,5,1281012.66065932,4353954.79998685
0,25,3,3,2,4,12,2093500.00275438,8489909.13446123
1,30,3,3,0,7,13,2202285.74823571,4775706.73789194
1,32,5,1,1,7,14,2023477.95794287,5347853.73271762
1,11,0,2,1,6,9,2165323.35256919,6678153.20453285
1,15,1,1,1,4,7,1726087.96929351,5301588.82742741
1,16,2,1,1,7,11,1959295.75574896,5125204.65178851
0,31,4,1,0,6,11,2155268.77852718,4272466.80493166
0,29,5,2,1,7,15,2313433.59147889,6284383.28896425
1,22,6,2,2,1,11,2265953.9231675,9088912.32426178
0,13,1,1,2,4,8,1495358.8255084,5275029.5101893
0,13,4,3,0,3,10,1999291.36942019,9393922.68896604
1,24,5,1,0,4,10,2217837.92909646,5245633.75307315
0,20,2,0,0,3,5,1853412.89581543,5321378.1691666
0,34,6,2,0,3,11,2076628.36427697,8153941.57247061
1,17,6,2,0,2,10,1934454.52158029,3330525.52150248
0,23,5,3,1,4,13,2934660.76835333,6673071.47286304
1,25,0,1,2,1,4,1446443.34907563,5488555.45129311
0,35,3,3,0,4,10,1889044.41815593,4331746.15806036
0,29,0,1,2,4,7,1647924.16744329,7449313.14072244
1,22,0,1,0,4,5,1343360.54523317,3796005.52667228
1,12,3,0,1,4,8,2057574.70887142,4035501.85522325
0,29,3,3,2,4,12,2312626.04382709,6283855.39259051
0,34,2,3,0,6,11,1910888.89764105,6810243.22833371
0,19,3,1,0,2,6,1704432.41725946,2730604.22944287
1,15,6,0,2,6,14,2231135.83236518,5585877.8835327
0,10,5,3,0,1,9,1881287.20938157,3908440.601987
0,30,2,2,2,0,6,1694847.01663747,5819115.83706171
0,34,4,2,1,2,9,1996129.45932531,5989199.97492356
0,10,3,2,0,6,11,1576609.08093094,9021134.29076249
0,10,0,1,2,1,4,1491595.94532885,2582627.1349248
1,16,6,3,0,6,15,2838438.98394739,6587681.65799765
0,32,4,2,2,7,15,2763726.65111005,2480716.66151782
0,36,5,3,1,2,11,1964794.56338605,6350168.59080856
0,37,3,3,2,4,12,2444803.80554602,7516472.22729454
0,12,6,0,1,4,11,1778203.24208839,9570065.40824664
1,30,1,3,2,4,10,1900387.05340224,6792780.68719461
1,15,0,0,0,3,3,1629748.50809408,3628348.35836469
1,12,3,2,1,1,7,1863184.94534318,5452101.09376551
1,12,2,2,1,0,5,1089934.95903909,5613601.32398979
1,27,4,0,2,7,13,1854091.42377711,7327015.60513127
0,23,1,1,2,5,9,2312476.01569347,5870284.91593703
0,26,0,1,1,5,7,1617321.14765126,3965219.85076472
0,10,2,0,1,2,5,1953452.13914423,5325082.57388128
1,15,3,2,1,2,8,1868355.47941053,5146114.27394644
0,37,4,2,0,2,8,1431813.97513824,6536404.08895855
0,12,6,0,0,3,9,1631970.22064612,8198474.20056259
0,40,4,3,0,1,8,2186834.8304994,7757102.70953301
0,32,3,1,2,4,10,2413960.91491628,4182620.8652299
1,26,2,1,2,0,5,1732089.17130501,5721888.41230735
1,22,4,1,0,1,6,1341584.39911884,1856479.81539229
0,37,2,3,0,4,9,2328552.57264125,3385123.11610557
0,13,5,2,0,1,8,1337277.26526432,3973430.33938675
0,23,0,0,1,3,4,1075728.80192046,2816068.39969781
0,17,0,2,0,6,8,1777070.5070771,7664509.86524178
0,20,6,0,0,4,10,1969041.75638406,6652770.39472692
1,33,2,1,0,3,6,1338352.95191876,7405965.44972552
0,35,2,3,0,5,10,1841410.30573533,5943333.12202164
0,24,0,2,0,0,2,1195447.32739237,3627867.57583578
0,23,3,1,1,0,5,1134840.93856237,3964677.50046184
0,14,4,3,2,1,10,1413723.03997338,5241219.77806363
0,16,2,0,1,5,8,1352648.09368885,6698338.1319438
0,20,6,0,0,3,9,1912476.82951293,7991066.31072141
0,10,3,2,2,0,7,1433106.11256068,4739281.60305788
0,20,0,0,0,5,5,1687579.60610893,5442375.57861565
0,14,4,3,2,7,16,2648079.61320484,9835413.64703595
0,35,1,3,0,3,7,1954140.59514069,2640451.69513116
1,32,2,3,1,7,13,2946384.68599037,5853540.99968285
0,13,2,3,0,0,5,1357202.35156542,3290040.06047986
1,17,2,3,1,5,11,1987007.7394312,6407630.301984
0,17,5,3,1,4,13,1931790.82765288,5376051.65425421
0,10,4,2,0,1,7,1326233.49051195,4438742.70720057
0,30,0,3,0,6,9,1714131.42286656,5224930.15992233
1,36,6,2,1,6,15,1533066.47591477,4648105.52003818
0,19,4,0,0,6,10,2293543.3356979,4011548.33978599
0,15,1,2,0,1,4,1274553.4057598,5702851.53250292
1,15,0,3,0,4,7,1484041.98611493,5782947.95858626
1,20,0,2,0,3,5,1623828.85195991,4478842.78408346
0,15,5,0,0,5,10,1951506.30549895,7491691.96593156
0,34,4,1,1,0,6,1866860.16585423,4517770.57284764
0,31,5,2,0,2,9,2212542.17564181,4403779.29630108
0,16,5,2,1,5,13,2992801.99801788,5119975.24412956
0,13,5,1,0,1,7,1680943.36979875,4100136.56690982
0,38,5,3,2,3,13,2577601.70844402,9173652.99958925
1,13,3,1,2,6,12,2242188.22474672,6381901.79198577
1,11,0,2,2,6,10,2236710.25851598,5841622.55245652
0,30,1,3,2,4,10,1793201.46506998,6581899.64968737
1,11,2,0,1,6,9,1881598.37863764,4900796.65619713
1,18,1,0,1,0,2,1366493.58073292,225354.701439999
0,16,6,3,0,1,10,2517919.30468987,7868551.4044427
0,19,4,1,0,2,7,1414625.32043948,3529311.98430787
0,28,1,1,1,7,10,2078567.88858707,6607972.21785975
0,35,4,3,1,4,12,2428754.50303645,4233339.82741276
0,38,3,0,1,6,10,1969659.44099737,11486098.2474263
0,40,6,1,1,3,11,2065344.0527879,5479670.19640375
1,10,6,1,2,4,13,2505612.72551791,5983902.77375258
0,26,6,0,2,3,11,2105503.72462299,9235424.71934527
0,13,3,2,2,6,13,2809195.26118184,5979934.1856197
0,36,2,2,2,5,11,2234055.37349518,8624867.00053231
0,18,1,1,1,2,5,1521624.84168992,2698960.45890498
0,20,6,0,0,5,11,1985568.56570825,2671857.97396558
1,33,1,0,0,1,2,1200714.69899424,4367546.0706674
0,40,1,1,2,1,5,1367966.00080161,3594667.35209967
0,14,4,3,2,1,10,2356659.56043632,7123468.88867979
1,29,4,0,1,5,10,2167613.07691235,4752572.81368705
0,18,6,0,0,0,6,2014220.90454092,7936464.9090227
1,24,1,3,0,2,6,2009258.68266022,7534436.84551485
0,39,0,0,1,1,2,1051221.36675362,3674025.42134656
1,15,1,2,2,2,7,1763112.14917713,2688666.73924334
1,31,6,3,1,4,14,2264241.00405208,7356372.61382362
1,22,6,3,2,4,15,2020562.32888163,8361837.77691505
0,15,0,0,2,3,5,1772607.21540315,5868937.34094626
1,17,0,0,2,2,4,1650524.72008093,6691694.94900528
0,12,1,2,2,2,7,1451801.52121263,3333247.4221063
0,13,6,0,2,7,15,1906138.3721323,6845891.94203352
1,30,0,1,0,6,7,1696536.31964812,7734604.43364016
1,14,0,0,0,1,1,1032903.14824574,4247789.7093183
0,37,6,1,2,2,11,2499337.31287087,8788680.72784456
0,19,5,0,1,7,13,2973868.39696084,7416181.42649979
1,13,6,2,1,2,11,2392159.64957353,3717105.88794338
0,29,4,2,2,5,13,1297185.99868815,8789687.94861161
0,35,1,1,1,3,6,1631342.66666547,5628460.77108853
0,38,1,2,0,7,10,2192215.42184616,3144726.34967115
0,38,2,3,0,6,11,1947528.79489552,4989348.02601085
0,32,3,0,2,4,9,1579903.48279459,5395240.90171964
0,10,5,2,0,3,10,2264908.63093025,5486242.40776378
1,20,5,2,1,5,13,3395752.5077871,3300719.35754225
0,30,0,2,2,7,11,2165778.00104881,4382002.85115726
1,28,0,1,2,6,9,2026429.25901842,4964794.80770375
1,35,2,0,1,6,9,1502720.38726992,4391216.71517711
0,29,6,2,1,5,14,2484125.21969472,7597508.80465269
0,28,1,3,1,5,10,1660944.42725988,5952856.91961422
1,28,6,3,0,2,11,2364918.90679978,5509144.1753596
0,17,2,2,2,7,13,2177329.18829633,10689842.0806651
0,17,3,3,1,3,10,1870625.15633645,6583495.31063829
0,13,4,3,2,0,9,1896379.14541123,6303860.38258734
0,11,1,1,2,2,6,1496067.97141593,6607374.65061753
0,17,6,0,2,7,15,2082487.87952709,9344785.55246212
0,14,2,2,1,1,6,1624315.41969698,5930718.59749619
1,20,4,0,0,5,9,2036164.59976109,2910849.3208707
1,35,3,3,2,5,13,1950076.94250934,9160703.17954085
0,21,2,2,0,4,8,1624631.41246116,7103019.33055047
0,15,4,1,2,4,11,2622407.09686394,5525303.11710471
0,25,2,1,2,1,6,1906313.80341402,3851032.76637088
0,10,4,2,1,5,12,2513689.10764379,7143226.25871491
1,32,1,2,2,4,9,2408724.56665166,7023955.57606448
0,20,2,0,2,7,11,2592257.49721924,9657320.1096158
0,14,1,1,2,0,4,1256488.60794555,4199974.72969563
0,31,2,3,0,7,12,2121244.29615691,3511498.50717419
1,33,4,3,0,4,11,2085922.74920211,7766667.35842893
1,36,0,0,2,0,2,1040859.06165601,3650747.94560774
0,31,2,2,0,4,8,1788016.98029648,6799293.88083695
0,21,2,2,0,4,8,1602981.00208389,1602981.00208389
0,39,4,0,2,5,11,2846202.46606103,6280437.5037079
0,17,4,1,1,6,12,1989835.77723788,5897781.65098413
0,36,5,2,0,0,7,1682910.30529097,4222727.17990709
0,31,6,0,1,3,10,1642380.60745484,6710408.42146385
0,15,2,1,2,1,6,1486235.77884736,4733754.20478379
1,37,1,3,0,7,11,1877998.51801031,7912968.32047421
0,10,3,2,1,7,13,2331990.04483154,6251976.69194745
0,17,1,2,2,0,5,1108126.5597326,6144393.65636777
0,34,2,2,1,4,9,1819435.86081474,2620543.26088434
1,32,6,2,0,5,13,1339178.85222512,7482271.87286052
0,19,5,2,2,2,11,2045856.82938566,6551040.61739384
1,36,0,2,2,3,7,1398624.50281386,4517544.01572707
0,24,3,1,2,3,9,1908100.87819618,4406684.52842075
0,33,2,3,0,0,5,1338256.63358183,2580311.05644907
0,25,6,1,0,6,13,2269329.64017951,10794480.4360027
0,34,5,0,1,4,10,2149524.88101271,3261079.69755652
0,35,2,0,2,1,5,1216929.56929249,2484744.43840241
0,10,5,1,0,1,7,2052040.13446833,5628586.31234497
0,18,5,3,1,7,16,2934322.85940748,9219025.9231639
0,12,2,1,0,4,7,1950048.9898396,6163950.83082739
0,29,1,1,2,5,9,1765154.51044853,5977289.51874282
0,30,5,1,1,4,11,1968562.28616707,2402726.39111698
0,40,4,1,0,3,8,1995212.91943883,6924862.27872458
1,11,0,1,0,0,1,694745.234107828,2946203.78381427
1,23,6,3,0,2,11,1765609.34910889,9097345.1416273
0,25,1,0,0,1,2,1249202.59350207,2598034.00524336
0,13,5,0,0,3,8,1641073.56062988,8163054.21713463
0,11,3,1,1,2,7,1922687.71778847,5884001.20056766
0,24,5,3,1,4,13,2027658.5049198,5516067.39590434
0,20,1,0,1,6,8,1586174.76296766,4499266.46067998
0,31,3,1,0,1,5,1696263.6712578,5198191.71923927
0,40,1,1,0,0,2,1226087.92415807,5684417.52792519
0,11,0,2,1,1,4,1372569.16826609,3441224.35132131
0,34,2,3,0,7,12,2250720.12632929,7506195.15351036
1,24,6,3,2,4,15,3024766.28100438,7147307.94854621
0,13,4,1,0,2,7,1574946.37725031,2351784.43645557
0,25,5,3,0,1,9,1692613.19071062,4831859.38078746
0,30,6,3,0,6,15,2680592.76903447,7155505.51402571
1,34,2,0,0,2,4,1389821.41707048,5242241.68629076
0,37,5,2,1,4,12,2150380.59879296,8115309.118617
0,36,3,1,2,6,12,2125146.15303982,5791435.20754036
0,33,0,0,1,1,2,1232008.69147339,1504141.59608109
0,14,2,0,1,2,5,1621802.7310052,2707889.41803667
0,24,1,0,1,0,2,1155900.76767774,2746075.45674588
0,31,6,2,1,5,14,2704656.46942385,5765982.02173269
1,26,4,3,0,7,14,2501942.13488105,5998971.0287431
0,40,1,0,0,5,6,1656717.32618127,3787374.82293659
0,16,5,0,0,2,7,1844660.92840917,3345022.97188792
0,25,0,1,2,5,8,1953074.82620411,4442650.93754488
0,31,3,2,0,6,11,2390455.5268543,9077647.26849006
0,21,0,0,2,4,6,1953633.2495331,3793770.6195457
0,32,4,2,0,4,10,2313495.83912188,5799231.30363452
0,10,6,0,1,0,7,1996939.92800691,5335917.34807956
0,33,4,1,0,2,7,2028725.90112281,9465679.59607755
0,27,2,3,0,7,12,2489810.11682017,4181149.66092723
1,37,4,2,0,6,12,2649839.04990278,7526398.52283711
0,28,1,2,1,0,4,1427745.30890415,3784071.54938117
0,24,1,1,2,0,4,1390764.1863969,7899837.71833673
0,31,4,3,2,7,16,3374211.46473009,5327793.08659805
1,24,1,2,1,4,8,1674372.04975635,3539767.86672205
1,24,3,2,0,1,6,1956398.71713897,1700075.00087118
1,23,4,0,1,5,10,1652646.08908661,5123742.94421349
0,35,4,1,1,6,12,2133568.47029008,7139310.16835196
0,24,3,1,2,5,11,2454366.24711736,8785574.11156937
0,14,3,3,1,4,11,2188646.99169722,5698628.2140608
0,34,1,0,0,7,8,1670692.16549383,5046471.05476706
1,26,4,2,1,4,11,1452265.81794467,7477095.09873746
0,12,1,1,2,6,10,1657772.99654015,6250591.49694775
0,10,5,3,2,6,16,2244974.56030099,7327388.80745021
1,17,4,2,1,3,10,1665738.45937369,4031833.27680787
1,12,3,3,0,3,9,2213831.74566471,5380903.17209189
0,20,2,0,0,7,9,1623276.26198508,7881990.48618621
0,33,6,3,1,0,10,1983015.48475694,1611158.59951238
1,14,4,3,0,5,12,2473845.52099037,7022044.54578342
0,19,3,2,0,1,6,1565533.84001903,5376923.37080215
0,21,1,1,2,4,8,1715426.7843913,4438982.99817441
0,21,3,2,2,5,12,2585463.22509919,10006579.6120103
0,29,6,3,0,1,10,1710767.94857979,6578547.62694575
1,24,6,1,1,7,15,3115360.80503076,6424698.48706506
0,27,6,0,1,3,10,1774207.38896952,5293527.76201583
0,36,6,3,1,0,10,1775593.58468009,9336917.88430872
1,27,6,0,1,0,7,1840741.96870919,9028319.7141262
1,28,1,1,1,7,10,2192316.75121796,8431594.30992075
0,16,6,0,0,6,12,2543974.69576675,6637023.39549398
1,36,3,3,1,4,11,1933521.18949295,6484756.5470249
0,33,5,3,0,5,13,3096913.35759691,5271650.12942385
1,37,3,2,2,1,8,1830121.09614309,6190506.22959479
1,32,5,3,1,3,12,2331261.95725764,8168189.06560114
0,15,4,2,0,2,8,2372784.22809938,5124354.48785978
1,33,4,2,0,4,10,1862165.73688685,6040193.07244712
0,13,5,2,1,4,12,2327584.50247206,9021642.85868318
0,27,4,2,0,4,10,2139060.33009516,7569064.90138664
1,34,3,0,0,6,9,1795428.7578985,5998036.13672221
0,35,6,1,0,7,14,3252215.70676967,4056463.16659309
0,29,2,2,0,7,11,2493757.58074503,9101950.97719901
0,12,2,2,0,0,4,1403259.92600439,2607821.67240731
0,11,0,0,1,1,2,823341.835774579,674335.231063881
1,35,5,0,1,7,13,2258744.05081041,4665267.10940357
1,29,5,1,2,3,11,1789397.83870835,8284772.80255812
0,10,1,3,0,3,7,1255134.13629863,2600103.48578714
0,12,5,2,1,0,8,1748717.16537181,3424827.56929502
0,13,4,2,0,2,8,1859006.48724765,6110757.27559011
0,32,1,2,1,0,4,1377855.92411244,5037853.08606455
1,39,5,3,1,6,15,2106215.53554042,9118576.32950099
0,30,0,3,2,4,9,1811868.51678409,6912624.97116398
0,19,1,1,2,4,8,2110916.9617745,2822299.09841757
0,31,6,1,2,4,13,2062655.20157161,5666127.91035719
0,17,4,1,2,6,13,2716096.61534067,7663659.01171635
0,33,1,0,2,3,6,1537378.19323761,4018263.17491916
0,34,3,2,0,4,9,2031372.34374606,6520966.94199992
0,37,5,1,2,2,10,1855647.34301764,8179337.92435897
0,20,6,2,0,0,8,2272960.74765547,5119857.84494301
0,14,1,3,2,7,13,2234474.88374905,4341926.96940165
0,13,6,3,1,7,17,2676539.44198592,13984296.531658
1,27,0,1,1,6,8,1042788.17700822,4576251.42442924
0,25,1,2,1,6,10,2417472.82628084,3311324.02178558
0,13,3,3,0,0,6,2024663.72316781,1409991.77110533
0,20,4,3,0,3,10,2278882.32016578,9345343.40589215
1,29,2,1,2,3,8,1672004.64248053,5489144.76292094
1,17,4,0,2,7,13,2192402.5020049,343578.665272361
0,32,4,0,1,7,12,2027283.23546497,5294772.53120262
0,23,4,1,2,5,12,2618818.4473027,7012456.8631138
0,24,5,3,0,1,9,1654271.42803204,5859044.12030817
0,20,6,2,0,5,13,2077122.08122166,4884756.48132402
0,10,0,0,1,7,8,1556044.14682457,6226259.27830609
0,25,6,0,0,4,10,2223646.06547314,6413725.05108251
0,36,1,0,2,2,5,1168880.98781367,6783510.98425352
1,35,5,3,2,4,14,2917396.30957958,10121303.4679726
1,26,4,1,0,0,5,1565374.44815642,1921964.21505092
1,21,0,3,0,1,4,1212714.10927671,5496048.6986635
0,36,0,1,1,6,8,1829496.55126335,7434716.31066776
0,11,2,3,2,7,14,1731895.66820833,6136651.78255174
0,14,0,0,2,2,4,1304824.31213238,5799708.01052498
0,10,4,2,1,3,10,2294405.70778794,6637561.65007327
0,11,0,2,2,3,7,1125779.05776342,5220370.51758009
0,36,4,0,1,6,11,1238981.57276267,6118283.9740464
0,25,6,3,1,6,16,2340531.37955563,9917674.76745075
0,27,6,2,0,4,12,2412319.95969217,7753752.47519819
0,11,2,0,0,3,5,1344036.25810957,4171145.71557768
1,24,3,1,2,4,10,2238383.59538495,4771498.78503339
1,32,0,2,0,3,5,1849642.1567571,3917364.98313222
0,17,5,0,2,7,14,2886767.51794825,8189725.85153991
1,30,6,2,2,2,12,2235733.72295902,4817019.49724343
0,36,5,0,0,0,5,1796673.09198684,6786158.39261457
0,29,3,1,0,3,7,2117717.20807708,7332381.63435996
0,21,1,0,1,1,3,880495.908620645,5293117.7832623
0,28,5,0,0,4,9,2239054.43312685,6515785.29111367
1,19,2,2,2,3,9,2392003.21767677,6942721.00120542
0,28,4,2,2,5,13,1900666.14148622,8474349.8912908
0,16,3,3,1,2,9,2084258.48811383,5184914.77258017
0,22,0,1,2,5,8,2409758.52534216,3255560.51233987
1,35,3,2,1,1,7,1987771.14462964,3821118.1982992
1,13,3,3,0,6,12,2514262.89442861,6190632.61473252
0,27,0,0,2,6,8,1686013.43270968,7701787.12267136
0,36,6,1,2,1,10,1805070.91635029,6934520.20641487
1,35,2,0,2,2,6,1503865.98313099,2604647.55087898
0,29,0,3,1,2,6,1407518.47217977,5824736.09881505
0,35,6,2,2,0,10,1795024.6593429,7845975.26715563
1,16,0,1,0,5,6,1736667.18008228,3298978.99228526
1,39,4,3,0,6,13,2005850.68579392,7760824.07206029
1,37,1,1,1,2,5,1158540.75990323,2623111.33775565
0,17,5,2,0,4,11,2060140.76149335,6310281.02333081
0,38,1,3,2,0,6,1455447.40171697,3733193.51084352
0,31,1,1,1,5,8,1997892.73583548,8403640.73913963
0,11,3,0,2,1,6,1564079.57586516,1084809.60761604
1,18,0,0,1,7,8,1697819.85585522,5392399.34618562
0,32,2,2,1,4,9,1981464.14308335,5137771.97818219
0,38,2,0,0,5,7,1478600.55857281,5126469.0077546
0,12,1,0,1,7,9,2124157.93390003,5907636.48876107
1,40,3,3,2,2,10,1789368.04066425,6460567.92910948
1,23,5,1,1,3,10,2194762.07688438,8081941.33277114
1,40,6,0,2,0,8,1884118.68768318,8151870.11661635
0,27,0,2,2,0,4,1300674.79471659,3255697.58410383
1,22,1,2,1,6,10,1823948.9209848,5849129.73566121
1,40,4,3,0,0,7,1476510.38920993,4440903.59098476
1,26,3,1,0,0,4,1093125.25882056,4635550.00286614
0,31,4,3,2,5,14,2197229.27039909,7676294.8802453
0,20,4,0,0,1,5,1400871.40088253,4003396.68767206
0,40,4,3,0,7,14,3001852.00337783,9035437.40228281
1,14,6,2,1,3,12,2488068.2017334,1962044.30669839
0,33,6,3,2,1,12,2209349.28403331,7353421.62014768
0,33,1,3,1,5,10,2221011.75901999,5036968.16145972
0,14,5,0,2,6,13,2860520.81936946,8961708.52928635
0,39,1,0,0,2,3,1251708.00607503,4132364.24497843
1,10,0,0,2,7,9,1854567.77189985,4990571.6240645
1,18,0,2,2,1,5,1185203.90760047,5155430.96475885
0,36,5,3,0,0,8,1410328.01642535,4082449.19291825
1,35,1,1,1,1,4,1390056.13060848,5064856.91981183
0,28,4,0,1,2,7,1422741.98006292,5551332.28901016
0,40,0,1,2,0,3,1105410.17907324,1136386.75353647
0,10,2,1,0,0,3,1581500.16540003,3361683.9721059
1,38,2,1,0,5,8,1299929.00583947,4781567.00564036
1,29,2,3,2,1,8,1680907.13786853,6879124.05345982
1,19,6,2,1,0,9,1713254.2234852,6346537.43169436
0,19,4,0,2,2,8,1955752.06888578,4164636.96842484
0,10,4,2,0,0,6,1697664.11786169,5621782.58603464
1,31,6,3,0,0,9,2180932.36029366,5327989.90237874
1,20,6,0,2,3,11,2518215.0902198,10075287.4602672
1,33,6,1,0,0,7,1587623.17447928,1575299.1970263
1,14,0,0,2,0,2,1187720.73960112,5681746.38573417
1,13,6,0,1,3,10,2019041.01237669,5752359.40794786
1,12,0,0,1,4,5,1376785.39368655,2101464.89951078
0,12,5,2,1,7,15,2350139.67507014,7349443.72269618
0,16,2,1,1,3,7,2433222.80436804,4916961.27893472
0,20,5,1,1,7,14,1632141.71192778,5815193.34311627
0,15,2,1,1,4,8,2226020.15325587,4607151.00114188
0,31,4,0,1,1,6,1688519.62201901,3784487.60335199
0,11,1,3,0,1,5,1730673.43912282,5219428.2821697
1,25,4,2,0,1,7,2089746.2018614,5737649.47250686
1,22,1,0,1,3,5,1514019.60395082,2717236.7996326
0,39,0,3,1,4,8,2001858.85758233,4211412.22836845
0,33,0,0,1,2,3,1292227.56548968,3418301.63010313
0,26,0,0,0,7,7,1965206.02917889,8850778.11777499
0,40,2,2,1,3,8,2315628.64120385,7113887.0651224
0,19,5,0,2,6,13,2947279.78781195,6382366.3805174
0,11,3,0,1,4,8,1459455.11038452,5961265.77704861
0,17,5,3,2,0,10,2066421.49630138,7191037.89355901
0,23,0,0,2,4,6,1551381.78730788,4160779.79918759
0,15,1,3,1,6,11,1827034.87721589,9307777.07321589
1,20,0,0,0,5,5,1888849.73746668,2817495.30385854
1,18,6,2,2,7,17,3365139.02646823,12615407.8746098
0,38,4,3,2,3,12,2139616.52435484,7699242.37914414
0,36,1,2,2,3,8,2131839.96132451,4959435.97285676
1,20,6,3,2,4,15,1914446.58924801,2108158.03149329
0,17,2,1,0,0,3,1495378.30850947,4912233.01531431
0,14,6,1,2,4,13,2267126.77860908,8307768.51575003
0,28,4,3,1,7,15,2686045.10418776,2427080.34786404
0,27,0,3,0,0,3,1610056.40347843,3972317.15109663
0,26,0,0,0,6,6,1678814.29060433,5369940.97445269
1,17,5,3,0,2,10,1790304.97469937,7901315.90159889
0,30,3,1,1,4,9,1952506.67473177,3835039.71802462
1,24,0,0,2,1,3,1103427.36162578,2944278.63283591
0,18,2,2,0,0,4,1803389.66324591,3517550.41235765
0,36,6,1,0,0,7,2153792.01798229,5473315.90554591
1,27,0,0,2,3,5,1277288.23259121,4650124.3993931
0,30,1,3,0,4,8,1826157.97733405,5802229.12690026
0,18,2,3,2,5,12,2238928.46323152,7807570.64262874
1,36,5,2,0,0,7,1729992.60836039,3698953.51679993
0,12,1,0,0,3,4,1330199.92327565,5844386.97896216
1,33,1,0,0,0,1,1131042.17521897,6022275.57110385
0,37,6,3,0,2,11,2517412.14696724,7909985.51933744
0,16,2,1,2,3,8,1647172.46288627,5774030.3608515
1,32,6,3,1,1,11,2259063.4938986,9078630.95525718
0,11,2,0,1,5,8,1919728.49412008,6103103.10984079
0,17,4,1,1,0,6,1721986.36670773,5199824.52341349
1,14,6,1,2,4,13,2180521.50746629,8372909.12712
1,17,4,2,0,4,10,2021793.41087059,5408249.04549017
0,29,3,0,1,4,8,1572499.25868252,6282515.72758741
0,35,1,0,0,1,2,1023597.73562319,7031305.58843235
0,18,6,2,1,1,10,2134825.73947143,5013463.28212649
1,27,5,0,0,6,11,2018100.77858015,5576832.71346949
0,25,0,0,2,1,3,1476369.98423967,4798990.31608249
1,23,3,2,0,4,9,2066004.83389812,8126459.58960745
0,13,1,1,0,5,7,1733904.50514561,6278810.07510382
1,24,1,1,0,7,9,2357034.15639993,4696685.35418378
1,16,1,1,0,7,9,2083344.45956879,3626519.41691286
0,23,0,0,0,7,7,2043412.14576927,8619883.03604473
0,32,4,3,2,4,13,3087834.38072105,8238992.43640042
0,22,0,1,1,2,4,1563024.83266975,7581188.90942025
1,40,4,0,1,1,6,1504057.90028905,5290751.57682916
0,34,5,2,0,2,9,1800000.87098416,5542798.99041668
0,29,5,1,2,4,12,2188866.14426049,6120603.37991126
0,21,3,0,1,4,8,1532927.59923477,5784106.61862589
0,17,0,1,2,3,6,1783905.27853625,3154970.90041539
0,12,4,2,2,6,14,1856092.10403527,7901447.73396062
0,16,5,1,0,5,11,1816199.25614905,6197905.78337638
0,16,3,1,2,1,7,1688104.91332312,5323019.70024269
1,28,0,1,0,1,2,1089673.65757421,4335668.79500592
0,15,0,3,2,3,8,2308602.96942705,7331981.65178326
0,24,3,0,1,7,11,1656531.34698132,5179499.14850817
1,40,5,0,1,7,13,2330224.17889606,8473609.38885245
0,31,4,2,0,7,13,2722546.37041198,6382368.41302601
0,12,2,3,2,6,13,1613643.88182966,6106177.06597006
0,33,5,1,2,7,15,1543352.91800034,5712667.67121435
0,36,2,3,0,1,6,2099739.71892734,5176316.76415757
1,12,5,1,2,7,15,2256272.03212265,3321808.40134693
0,32,2,3,2,7,14,2481506.47862101,6796069.06878675
0,11,3,1,0,6,10,1996433.11770448,4641108.49576097
0,27,2,1,1,1,5,1290621.05527031,5677613.12174721
0,25,3,0,2,6,11,2410723.62003006,6991483.9602677
0,39,0,1,2,1,4,1565747.07523576,2027608.25503368
0,19,1,0,0,3,4,1442651.33092974,3793959.14651553
1,32,3,0,0,6,9,2418112.4482954,4923781.55380925
1,24,6,1,1,3,11,1990433.78999361,4313511.53998667
0,36,1,0,1,1,3,1345528.85066697,3188471.43015722
1,14,2,1,1,1,5,1836666.47079038,3172786.04515109
0,21,0,1,0,6,7,2010966.03562985,4236023.48529793
0,35,5,1,2,0,8,2016952.23059872,4223843.05471004
0,12,2,3,1,7,13,1943357.21466555,8244891.24407613
0,34,3,3,2,2,10,1623796.6774447,3190695.2960658
0,39,1,2,2,7,12,1988677.11029474,7209492.77028048
0,30,2,2,0,2,6,1713512.65280593,8191492.48843439
0,36,0,0,0,1,1,1210008.2790265,2233715.5448457
0,38,4,2,2,2,10,1828097.08950921,5055388.50523135
0,21,2,0,0,4,6,1546929.26289317,7341038.79276213
0,10,6,0,1,3,10,2553474.31487043,4741583.35410957
0,32,1,3,2,4,10,1948357.50219858,5573159.22357413
0,20,6,0,1,5,12,2152003.18883568,7056476.23135393
1,12,1,0,0,4,5,1655585.96594066,6629042.65604856
0,24,5,1,1,7,14,1479715.40254607,5227910.95990013
1,17,6,3,0,7,16,2463855.62065355,6009513.68924243
0,40,3,0,2,0,5,1589247.50739872,4371219.97275275
0,15,6,0,2,3,11,2440465.1022571,6067648.92546722
0,10,3,2,1,3,9,1826851.0601369,7338653.73060292
0,23,5,2,2,7,16,2796861.98314401,8248752.90884174
0,12,6,3,0,3,12,2613952.67232221,9937804.80682918
0,12,1,1,0,0,2,1099886.02655102,3317816.89094769
0,20,6,1,0,2,9,2247914.18958179,7448040.6850261
1,31,2,2,0,6,10,2552274.13729649,3670906.87335907
0,11,1,1,0,5,7,1677506.71597011,5981992.81008701
0,39,3,0,0,1,4,1273524.90385954,4693012.69600294
0,36,4,3,2,3,12,2151523.67732125,4483527.49493081
0,14,0,3,2,1,6,1384298.5004201,4722449.18941573
1,39,1,0,2,4,7,1961780.31658096,4208735.38063744
0,10,1,0,1,3,5,1481793.41440084,3410951.01010865
1,36,4,0,0,2,6,1500022.90895234,3481230.55268339
0,20,2,0,2,4,8,1342074.48319341,6713160.79767364
1,18,6,2,0,1,9,1648549.36423827,5843438.13596154
0,18,6,1,0,2,9,1444411.13012842,6000762.889176
0,31,5,3,2,1,11,2450309.96462313,6891563.10350986
1,18,5,3,1,6,15,2437812.92318134,9183297.74854783
0,15,3,2,2,6,13,1913360.29512764,7692997.01666959
1,35,2,1,0,3,6,1683482.18155788,2397526.75862358
1,33,6,3,1,1,11,2517735.24902502,4896525.11927984
0,19,2,2,2,3,9,1825081.45325914,3223166.63639423
1,23,4,2,0,6,12,2017910.04399943,9668693.10778838
1,11,0,3,0,5,8,1527433.63329328,8759327.02354649
1,38,1,0,1,5,7,1479565.89205435,4871654.10598732
0,27,1,2,2,1,6,1844550.36952273,5551153.35904273
0,23,3,2,0,6,11,2327675.47244615,7684994.98594115
1,39,6,3,0,4,13,2207675.83715149,4688396.31857847
0,26,3,1,1,7,12,2418712.11730693,6337029.51585521
0,25,3,0,1,6,10,2118657.31232182,6546161.74637064
1,36,4,3,2,5,14,1986105.75559616,7013783.47981378
0,26,3,1,1,7,12,1606422.65054395,6209553.18734941
1,37,5,3,2,6,16,2867318.24826532,10085760.9065373
0,29,3,1,0,7,11,2503311.28772427,5602247.25287237
0,24,2,0,0,1,3,868630.300049003,5657681.56335708
0,17,0,3,2,6,11,2712054.71306496,4363739.83921778
0,18,1,3,2,2,8,1720114.17385953,5553877.481506
0,33,0,2,2,7,11,1589945.30851303,6129021.78830648
1,39,5,2,1,6,14,3342109.01936845,6673148.38904499
0,22,1,1,1,0,3,1208245.59105423,1225209.04098924
0,19,1,1,2,1,5,1508881.04598673,7109507.08678238
0,25,5,2,2,6,15,2337818.0126333,9812698.49184745
1,20,4,3,2,3,12,2010508.38038272,6683482.35516759
0,12,0,1,2,5,8,1247989.44016171,4344345.15872956
0,13,5,1,1,2,9,1872803.84146925,5636602.20092959
0,20,6,1,0,2,9,1675448.78082947,3316423.87069227
0,19,2,3,0,2,7,1753484.31839276,3437879.12007497
0,21,1,2,1,1,5,1536127.84941241,5136983.50177648
0,32,4,2,1,6,13,1656857.97911043,7055971.95857044
0,32,0,0,2,3,5,1239403.03844788,7050503.76669535
0,12,4,1,1,3,9,1883031.12404711,8257536.22592439
1,39,4,2,2,3,11,2544644.93144197,6062910.76613209
1,17,5,0,0,1,6,1573198.37726337,4755913.85659416
0,30,2,1,1,6,10,1789433.42446723,4619760.95554512
0,39,2,3,1,7,13,2442569.27257694,7261630.24144796
0,26,4,3,0,2,9,1930639.78514423,988108.894735033
1,25,1,0,0,7,8,1722260.13301575,5117722.5090217
0,32,5,2,1,3,11,1854815.10780811,6298543.03749694
0,37,5,3,1,7,16,2091337.3996778,7376633.67115596
0,12,0,3,0,7,10,2224347.27921601,4913332.44497521
0,20,5,0,2,2,9,1842489.68824021,4044763.99724763
0,16,1,3,0,1,5,1658534.05903046,3702625.63619005
0,33,1,3,2,7,13,2871165.1347671,9076492.57174722
1,13,5,0,0,0,5,1690837.83766025,4439963.1662522
0,34,6,0,2,5,13,2291863.56917314,4309132.69010716
0,36,4,3,0,0,7,1644449.91365836,4797868.39550834
0,38,5,3,1,3,12,2405045.57032511,7253939.74671953
1,18,5,2,1,6,14,2537858.55309618,9808867.0786688
0,20,2,3,0,1,6,1628739.87581726,4119692.34658042
0,17,4,0,2,3,9,1947033.27151912,8552764.59336942
0,37,3,1,2,2,8,1813753.40530045,3497414.52978807
0,34,6,3,0,6,15,2721480.74524714,7042671.58193537
0,13,2,0,2,7,11,1640665.4976434,4192397.85995259
0,32,3,1,1,4,9,1808191.96792918,2237112.20118421
1,23,0,3,0,4,7,1409167.27110154,2924838.07351489
0,32,2,2,0,3,7,1623464.36487206,7741352.20974913
0,22,5,3,1,4,13,2519129.21630036,8137144.15134001
0,20,0,0,2,5,7,1833653.55526019,6122791.86861302
0,36,3,0,1,5,9,2385448.17063982,8568021.25488644
0,24,5,2,2,3,12,2217644.23194316,4994600.01550485
0,33,4,2,0,0,6,1664186.43923485,4729846.80837037
0,31,4,0,1,5,10,1900608.85165518,7111584.83333239
0,35,3,2,2,4,11,1804610.87229112,6174337.18289277
0,27,4,2,2,7,15,2418195.65921651,7629054.09774044
1,10,6,3,1,6,16,1906009.59705424,7377963.56781582
0,35,1,3,1,3,8,2071241.35281999,3964868.09846881
0,27,4,1,1,0,6,1962913.26937395,4550731.89295603
1,17,0,0,2,2,4,1432285.23900311,4025747.03744237
1,39,6,1,0,4,11,2088462.32132241,1642695.98397663
0,23,1,3,1,2,7,1922336.96944022,4408850.16800278
0,17,0,3,2,7,12,1762158.49910669,5764823.56452352
1,18,5,2,2,7,16,2697917.91920911,6513043.4633519
0,17,6,3,2,6,17,2497623.61218859,5221315.70150965
0,32,2,2,1,5,10,2008763.95011164,2749551.63923614
1,17,0,3,1,5,9,1958901.30491151,5290987.84689221
0,31,4,2,2,1,9,2064011.17230641,7195465.37637171
1,32,5,3,0,2,10,2099466.84222747,3918230.83268784
0,24,6,1,0,2,9,2020681.48835933,4932760.26038169
0,40,5,1,0,1,7,1785899.53373683,5364448.82395114
1,19,6,2,0,1,9,1718092.63185799,4315175.45791922
0,31,3,2,0,6,11,1805764.83021722,9082371.46981668
0,36,3,1,2,4,10,1849597.8941586,3453574.43809793
0,23,0,0,1,2,3,1276880.12079425,3900871.17565276
0,36,2,3,1,6,12,2220592.22935138,6859483.81132324
0,12,0,3,0,6,9,1943853.61482432,6412927.87173989
0,27,1,0,2,5,8,1756222.04451466,2248148.0113868
0,16,5,1,2,0,8,2440047.5006442,4746322.39633397
0,35,0,0,0,3,3,1620025.26982509,6868887.35885089
1,13,4,0,0,4,8,1611866.21890231,5968048.44457147
0,10,6,1,1,4,12,1969238.3184983,1969238.3184983
1,15,1,2,0,6,9,1538568.95202153,6223639.06690725
1,36,0,1,1,3,5,1201936.06750309,6646732.60173488
0,24,0,3,1,7,11,1885529.49924379,8190233.23382991
1,36,1,2,0,6,9,2079996.716916,5326130.1520372
0,21,5,3,1,2,11,2431176.11960342,5091693.18192227
1,30,5,1,2,3,11,1585242.49592326,2614966.63639226
0,20,3,0,0,5,8,2142950.25777692,5237828.15881008
1,34,6,3,1,2,12,2501761.34063269,6507510.20966104
1,28,4,0,2,7,13,3086458.95659298,7676946.09030697
0,38,3,0,2,0,5,1642332.82831922,4655361.96372374
0,21,1,2,2,1,6,1793384.16295765,6855808.27848175
0,36,4,1,0,0,5,1323230.86703641,2694090.42431106
0,40,5,1,2,1,9,2290029.71873447,6581822.28073507
0,38,0,3,2,1,6,1454606.59959482,7723166.66268459
1,16,3,0,2,7,12,2517023.18864893,8959621.02716334
1,35,3,1,1,6,11,2827108.53816203,5693762.3069188
0,26,5,1,2,2,10,2186663.09505523,5742779.83367712
1,21,3,3,0,4,10,2237061.4083945,8762121.63060708
0,31,2,0,1,5,8,1539551.10150907,6174407.12460115
0,30,1,1,1,3,6,1253881.20164764,8674604.30661963
0,25,5,3,0,4,12,1231977.6968595,8429318.15684407
1,38,0,3,0,5,8,1554021.17236766,7840185.2196723
0,20,4,2,0,1,7,1131694.691224,4597908.62547147
0,30,4,1,2,5,12,2025254.8900369,6448535.97861919
0,27,2,3,1,2,8,2002354.9769599,3487605.35017518
0,18,3,2,0,0,5,1476521.44705125,4465837.18809504
1,40,2,3,0,6,11,2137179.48637598,9213156.68234728
0,14,3,1,0,1,5,1711431.34425205,4913189.45620652
1,27,2,3,0,3,8,1537228.35456842,4461768.508433
0,30,5,1,0,7,13,1859456.62648079,6739199.8383085
1,39,6,1,1,2,10,2192035.19473119,6041302.44166015
0,32,1,3,1,2,7,1794002.5187455,5735506.50628825
1,16,4,3,1,6,14,2216155.86656022,6661111.70291341
0,22,5,0,2,7,14,2968009.08393437,8869630.25884134
1,28,1,3,2,6,12,2861926.11152791,4118783.08728546
0,14,0,1,1,1,3,1578341.19208422,3110099.35120065
1,15,2,1,2,6,11,2043301.27617905,6648237.75428336
0,32,3,0,2,2,7,1380546.67083365,6504105.99838542
0,21,0,3,0,0,3,1532650.95032195,3572774.87608449
0,24,2,2,2,4,10,2437347.79191334,6011844.16310244
0,33,1,3,1,6,11,1962053.5204544,5329421.01995648
1,12,3,1,1,7,12,2175103.40057654,5980653.26585244
1,29,0,0,1,0,1,1008863.28146242,3919914.75779424
0,23,6,0,0,2,8,1485166.8863868,5219350.81305564
0,38,4,2,1,1,8,1433949.52991112,7183168.9976977
0,18,3,0,1,7,11,2351180.54763209,8137370.9699561
0,36,1,3,2,6,12,1977313.41256882,7218079.04069068
1,29,1,1,1,7,10,1961959.6153677,6882798.61618801
0,30,0,2,0,2,4,1562024.31042723,3141080.09474904
0,35,5,0,2,1,8,2133299.066901,6332761.10388811
0,35,0,0,1,4,5,1575381.61221953,4017236.96009528
0,31,0,3,1,3,7,1687258.52511388,4447223.67983863
0,17,6,1,2,6,15,2600376.75902356,8148814.45696272
0,31,4,3,0,5,12,2197571.22412782,3982490.33459792
0,18,6,0,0,6,12,2344621.72187937,4838032.53349731
0,12,1,2,2,5,10,2536120.76780019,7680872.32269209
0,22,2,1,1,4,8,1670683.83765286,5734859.29322194
1,21,6,1,1,2,10,2088030.33073019,6096610.04972184
1,40,0,3,1,2,6,1620064.85010451,2301891.45172454
1,23,0,1,0,7,8,1026531.86418963,6830077.64343615
0,18,0,2,0,5,7,1666863.85944119,3679773.2280796
0,17,0,0,1,7,8,1383533.49305776,3207322.44454261
0,26,0,2,0,0,2,904531.629131981,2361857.66766116
0,14,4,3,1,3,11,1921114.11909195,5645552.41527193
0,24,4,0,2,7,13,2702442.64860736,9815005.94704415
1,16,4,2,1,1,8,1478342.2792067,3497482.66258471
0,36,2,3,0,2,7,1223808.50332672,3744086.30744674
1,37,1,0,1,6,8,1839077.50089068,3939061.47203933
1,17,4,2,0,5,11,2206194.8214963,4703558.21545864
0,17,6,3,2,2,13,1988562.4412937,7592215.17518737
0,37,5,3,2,1,11,2010045.87852431,10043899.9579666
0,35,1,2,1,4,8,2484468.80741813,4159495.54667316
0,30,2,1,0,1,4,1572269.70362608,3741237.67231567
1,11,2,0,1,1,4,1656324.15360795,6397282.3922539
1,40,5,1,0,5,11,1856221.98483163,5757660.58529046
0,15,2,0,2,7,11,1845059.61833271,7813306.38388633
1,19,3,0,2,7,12,2108588.35910179,8871879.60682387
0,26,1,1,1,6,9,2152095.17966646,8357436.87351592
0,38,4,1,2,1,8,2206015.5993012,3204196.89462011
0,15,6,0,1,2,9,2054385.92471016,6236811.16057709
1,29,3,1,2,6,12,2407070.44586563,5573565.32996138
0,23,4,3,0,3,10,2097211.74304349,6326955.35148972
0,35,1,0,0,7,8,1667632.15333185,6842084.60036167
1,32,4,2,1,1,8,1806128.16476795,3799100.05507967
0,10,5,0,1,1,7,1856406.02995438,3670639.45523079
0,35,6,2,1,6,15,2245170.95667798,5101929.22476277
0,24,4,0,2,3,9,1657130.15897081,6440085.8346532
0,18,2,1,1,0,4,1256233.79479139,3116433.43622938
0,33,2,2,0,1,5,1352948.93585824,10354492.2988138
0,26,5,2,2,2,11,1862641.52553966,4289668.02613716
1,40,5,3,1,2,11,1749706.43599174,7131788.52191615
0,10,4,3,1,5,13,2302824.94932657,8216131.50646968
1,13,1,2,1,4,8,2142971.42300808,4980578.64111733
1,19,2,1,1,0,4,934914.725078832,2704661.88177062
0,10,3,2,1,4,10,1818517.01552764,5133122.09919004
0,29,3,1,2,6,12,1657828.65754301,7735264.03140055
0,17,2,0,0,1,3,1456860.29121359,4974494.22830498
0,36,6,1,0,7,14,2589745.74073849,10396214.6517304
0,16,4,0,1,5,10,2099315.99823834,7769535.20607352
0,32,6,2,0,1,9,1984455.50383443,7422523.50497665
0,12,0,2,1,7,10,1948076.32448511,4198528.14991653
1,15,1,3,1,0,5,1236983.76166131,6245134.02073202
0,19,3,3,2,0,8,1832134.41111636,9855208.30769473
0,38,3,0,0,0,3,905673.079773024,4841656.67686633
1,28,6,2,1,4,13,1678244.21774112,10523772.1310324
1,34,0,3,2,3,8,2417086.44371869,5356204.89518196
0,13,5,3,1,4,13,2239765.07574262,5910112.91870304
0,35,2,3,1,0,6,1494466.70610147,5032824.54838033
0,12,5,1,2,4,12,2067833.93784876,8475509.20415178
0,39,2,0,0,6,8,1944981.03559221,1168366.78166351
0,31,1,2,2,5,10,1908643.16529507,2153451.30039587
0,11,0,1,0,4,5,1306050.77166008,4528924.42394345
0,23,3,2,1,1,7,1522025.3650668,4088446.06885832
0,14,6,2,0,6,14,3033159.91057417,3607071.56346915
1,15,5,2,0,3,10,1264121.99391395,6192227.05689601
0,10,4,3,2,0,9,2369474.16764079,7218296.38729779
0,37,4,1,0,7,12,2817506.91303909,7560123.14210539
0,38,3,2,0,2,7,1378224.9764327,6236539.87427916
0,12,3,2,2,6,13,1726425.66567686,5507570.67812699
1,12,1,3,1,7,12,1992989.72247034,5130338.00799367
0,23,4,3,2,2,11,1901008.14099947,8397039.89618816
0,32,6,1,1,6,14,2681590.33660443,11280198.2541367
1,28,4,2,2,2,10,1278273.26078669,5858921.36844332
1,33,4,2,1,7,14,2367215.6046953,9519057.78799269
0,19,1,3,0,6,10,2193972.38556369,6334637.96404501
0,21,4,0,0,2,6,1353711.65423038,4081039.88792055
0,28,4,0,0,0,4,1377191.60364854,3957788.49379285
0,11,6,1,1,6,14,2386854.36955037,9225865.29696221
0,37,3,1,1,4,9,1778388.42064126,7389134.39114127
0,25,2,1,1,2,6,1656242.47683231,6055869.75148842
1,21,5,0,1,4,10,1718584.46116687,5800592.94049385
0,20,5,3,0,2,10,1616885.82058241,4853509.75076173
0,11,2,0,2,4,8,1632082.70607574,5541768.43933485
0,27,3,0,2,2,7,1634032.37664134,5386365.53062495
0,11,1,2,1,5,9,2270850.88074415,5137068.24518223
0,14,0,3,1,7,11,1968883.44528104,7104994.78093961
0,15,3,3,1,4,11,2130049.17848757,5833411.97578784
0,27,0,3,2,1,6,1475665.59970553,4153806.71547056
1,38,1,0,1,2,4,1509543.50515691,4414150.54692161
0,31,6,3,0,6,15,2111104.59304225,8024898.77559593
1,32,0,1,0,7,8,1919770.31027202,5736840.02383667
0,17,1,1,1,7,10,1784302.52269102,5492488.04521678
0,32,6,2,0,3,11,2091880.10969952,9505906.82242298
1,39,0,0,0,4,4,954933.694245685,4398816.06985634
0,19,2,0,1,5,8,1476407.05514475,3864209.34519037
0,26,4,1,0,7,12,2389026.77278552,5134999.38914687
0,29,6,1,1,1,9,1802308.29339929,5440855.37250206
1,38,6,2,1,7,16,3080074.28568229,7457203.91245311
0,29,5,3,0,5,13,2115793.77605428,6137384.84486485
0,31,3,0,2,5,10,2200561.57796205,5577552.22653844
1,10,4,3,2,5,14,2535051.21074439,7154819.54726811
0,23,6,3,0,4,13,2334452.77290371,7119158.87749311
0,17,6,1,1,6,14,3377929.50814174,4979084.17419543
0,35,1,1,0,6,8,1713736.98949827,3764757.69898453
1,35,3,2,2,1,8,1581942.52234968,5814421.34065849
1,36,1,0,0,2,3,1145414.72826151,1104170.40429883
0,38,0,2,2,7,11,1416256.07969045,2822432.52858883
0,10,6,2,0,6,14,2210498.81692889,5085845.14845612
1,19,5,0,0,5,10,2102498.27025419,7720672.1289644
1,25,3,0,1,3,7,1150053.45861748,7720044.19617484
0,15,1,3,2,3,9,1712466.70684271,5637892.4594234
1,39,4,0,0,5,9,1943902.67706052,9104015.3958311
0,28,5,1,0,1,7,1768725.1376297,6520421.36235189
0,37,4,2,0,5,11,2495620.45300277,6690793.30334879
0,18,5,2,1,5,13,2196815.52549942,7887399.19663351
0,37,3,3,2,4,12,2369693.17133822,8193549.4342487
0,14,0,3,2,5,10,2292527.43217481,8581474.689302
0,12,4,3,0,6,13,2820082.87977387,5813557.48602866
1,38,0,0,2,1,3,1327946.4161777,4100298.13304037
1,27,2,2,2,4,10,1754770.71005034,4813600.58510243
0,32,2,2,0,7,11,2455669.98768916,8276991.24179446
1,32,5,1,1,6,13,2487225.79602074,10022187.7174946
0,36,2,0,1,1,4,1258916.93588586,1955181.8856668
0,23,2,2,2,2,8,1811718.39281049,4884600.65765941
0,29,1,1,0,0,2,1074786.31229026,2650622.78904482
0,39,3,3,1,5,12,2202819.26270766,3870033.13786011
0,32,4,0,0,5,9,2055494.12304105,4919625.73463291
0,20,1,0,2,4,7,1384964.74510605,7420833.29235754
0,26,0,3,1,5,9,1691778.78695075,4425606.09446026
0,25,1,3,2,7,13,1747259.7123033,10634069.5503323
1,38,0,2,1,3,6,1465028.49393283,8035448.62144746
0,29,4,3,2,0,9,1667863.52779568,6385434.36123496
0,39,6,1,2,1,10,1635735.94545045,6225934.38301696
0,22,3,2,1,2,8,1756803.80256482,4655523.76350742
0,32,6,3,2,7,18,2981193.07473825,6395325.56654038
1,13,5,2,1,4,12,2189255.25024411,5820698.1823286
0,17,6,1,0,4,11,2593748.37941467,7415198.07271491
0,40,4,2,0,0,6,1651477.75435646,4163962.60474315
0,34,3,3,2,7,15,2621995.91746564,5306470.30400262
0,29,0,2,0,5,7,1760805.84785564,6487130.20789817
1,26,3,3,0,2,8,1871701.42683229,5753295.67515237
0,39,3,1,2,5,11,1904588.64634482,7081867.33384077
0,37,0,3,0,0,3,1347152.88040959,4247306.57431425
1,37,5,3,2,3,13,3091394.90811403,7230943.91299059
0,20,6,3,0,5,14,2389631.53048142,6606278.21060066
0,35,6,2,2,2,12,1804481.62596333,5599151.32141111
0,16,6,2,0,6,14,2669184.84645962,10024584.2690925
0,31,1,2,0,5,8,1688755.49747201,7364508.93578078
1,11,1,2,1,6,10,1972922.07336592,9096084.3237529
0,28,5,2,2,6,15,2198623.84971356,2845582.27264458
0,28,4,2,2,0,8,1579378.66445537,2898776.19149278
1,37,4,0,2,6,12,2615433.67013903,4028697.23327298
0,39,6,2,2,6,16,2246086.72979943,6426346.7358311
1,26,5,0,2,1,8,2038951.95431292,6448927.63173606
0,34,4,3,2,1,10,2227076.91529459,6692713.54770294
0,28,6,0,1,4,11,2428624.99910658,6497297.32794581
0,19,6,3,2,2,13,2716250.41539858,8500095.03950541
0,40,5,0,1,6,12,1820036.946157,6472020.45428407
0,40,5,0,0,4,9,1470083.11804911,2765999.87183234
0,31,2,1,2,4,9,2000497.28592105,6814798.5975016
0,33,3,1,2,6,12,1915278.07923639,5273036.35568532
0,10,5,1,0,3,9,2067840.04587457,6715683.17030785
0,36,5,1,2,5,13,3080994.33171778,9479648.26032416
0,32,1,2,2,4,9,2218524.85820305,6199338.60621552
1,22,5,1,2,4,12,2435953.43490433,3030477.85650484
1,31,0,3,2,6,11,1848006.85875315,6583982.9593678
0,13,0,3,2,6,11,2178077.79180441,4751973.28229252
0,20,2,3,2,1,8,563249.316289035,7648819.21956611
1,25,2,0,2,7,11,2412207.69881776,5922771.38952822
1,26,5,0,1,3,9,1689709.39332942,6542059.50977616
0,28,3,0,2,4,9,2067553.33040383,4333315.50819149
0,16,0,3,0,1,4,1269210.4034349,3017503.08504459
0,32,0,1,0,5,6,1994634.57025829,6232284.18136471
1,14,3,2,1,0,6,1875075.23804358,4241288.57300684
0,30,6,0,0,2,8,2144718.42166466,3834056.716348
0,40,6,3,0,7,16,2715294.13015368,8680169.57914329
1,25,6,3,0,1,10,1943093.64071207,6304512.77686033
0,25,1,2,2,3,8,1555193.0748744,5731854.72216918
1,16,3,1,1,4,9,2040602.75967049,5407601.57567513
0,36,3,3,0,4,10,2007003.21085007,3826788.78466227
0,10,6,3,0,5,14,2406585.26363122,5408035.34447146
0,10,6,1,1,3,11,1533811.88667476,7653946.13419847
0,38,0,2,2,6,10,1825801.19593598,7917190.89233555
0,30,3,2,1,2,8,2099474.38314753,5717493.56210023
0,19,3,1,2,4,10,1861269.88062232,8351624.84285828
0,30,3,2,0,2,7,2153435.31077474,1886083.04926293
0,32,2,0,2,1,5,1300376.96099244,3291784.50229359
0,17,4,3,2,5,14,2705774.60871502,1733975.94485986
1,10,2,0,2,5,9,1663246.50901398,5560696.30044146
0,13,4,3,2,4,13,2132913.07607038,6565794.17086156
0,33,6,1,1,1,9,2145312.43307966,6230607.10380515
0,34,5,1,1,0,7,1837694.13081991,4926476.7239384
0,33,2,1,0,2,5,1348652.56694982,5538161.77765824
0,31,1,3,2,3,9,1951868.09528709,4488564.14790244
0,29,5,1,1,2,9,2267728.78338207,4435280.91882312
0,28,0,3,1,7,11,2737968.52567941,5934160.23035031
1,23,5,3,2,3,13,1827546.77591324,9061454.69388379
1,35,4,2,2,0,8,1963175.17565661,6203842.92794657
1,37,6,1,0,1,8,1844911.443258,6649560.85654908
1,38,2,3,0,2,7,1792411.10800541,5426267.53796938
0,14,1,3,2,0,6,1722240.71881901,3762206.2193178
0,14,3,2,0,3,8,1806341.92905026,1928784.31433128
1,15,2,0,2,1,5,1327965.38254432,5333039.00190344
0,11,0,0,0,5,5,1322689.77489385,4640197.35254513
1,17,5,3,0,7,15,2403028.89905847,7452278.248714
1,11,2,2,0,5,9,2107970.232795,6656516.05291127
0,12,2,0,1,0,3,1735897.94953644,5809631.91673309
0,39,5,2,2,6,15,2918393.46161385,5228393.9821802
0,21,5,3,2,7,17,2370715.02526456,8296384.1237076
1,33,4,2,1,3,10,1996435.173923,7488119.65261742
0,22,2,0,0,2,4,1542753.95378307,3346978.80273724
1,19,3,3,1,2,9,2607634.5049291,3255086.04928017
0,31,4,3,2,3,12,2053556.37673178,7343828.08158899
0,26,2,3,2,0,7,2189629.31195603,6649705.40647134
0,13,4,3,2,0,9,1874731.71243409,2367900.78801207
0,10,2,1,0,5,8,1869744.16436816,8268940.51199315
0,37,5,2,0,6,13,3106497.70597637,2941556.01699448
0,18,6,2,0,6,14,1158017.76453646,5041938.11725966
0,34,5,0,1,3,9,1321323.60469504,5636514.25824676
0,35,5,2,0,3,10,1616384.34998544,7006478.81223522
0,29,4,2,1,2,9,2103658.40316893,4585865.66807688
1,18,6,2,0,3,11,2237169.38115124,4293780.77136758
1,34,4,1,0,5,10,2474425.00653391,7622144.43170391
0,32,6,3,2,1,12,2537535.10174875,9377818.35023993
0,20,3,3,1,5,12,1888727.44250817,4490176.99771928
0,12,2,3,0,5,10,1892665.64891312,5045567.54750924
0,38,2,1,1,1,5,1417245.05128252,5261898.06065895
1,29,4,3,2,1,10,2542270.45826554,5242584.47205726
0,37,5,0,1,4,10,1445115.73027658,3448618.40443531
0,26,2,3,1,5,11,2120414.87632931,5924722.0107734
1,40,0,2,2,7,11,1765614.23227571,2529449.70334809
0,14,5,2,2,1,10,2132295.9857481,8502495.77181552
0,24,5,3,0,0,8,1743901.35418425,4046877.81356538
0,40,1,0,0,4,5,1469341.04813314,2709651.81536062
0,23,1,1,1,0,3,1436754.45763771,4269504.12498953
0,39,4,1,2,5,12,2338827.81196647,7032672.03060917
0,21,1,2,1,4,8,1517928.73078955,7435135.82675099
0,38,2,1,1,3,7,1844182.59999963,4093858.43428563
1,29,2,3,0,1,6,1762961.58520201,5650166.41386331
0,32,0,2,1,6,9,2157375.18665919,9865880.84336292
0,28,2,1,1,6,10,2198244.66320698,4994731.21186772
0,14,6,2,2,2,12,2195716.29817449,4197180.89709509
0,35,0,3,1,4,8,1471796.72448516,6303691.02841907
0,11,4,3,0,4,11,1882838.69792287,3420753.87960588
0,20,1,0,1,2,4,1319140.05245694,1262508.64991281
0,29,1,1,2,1,5,1688869.36997996,4249390.18332942
0,28,1,2,2,5,10,1707105.30569176,4481015.8150963
0,22,4,3,2,6,15,2078290.44199254,4846728.84664295
1,16,2,0,2,2,6,1333654.31867932,6737288.6700085
0,29,6,0,1,3,10,2325402.83635705,7530905.66808012
0,39,2,1,2,4,9,1701580.94400038,6330569.54991036
1,37,4,1,1,1,7,1283356.15364464,5017724.39252876
0,12,3,2,1,2,8,1911113.37134722,6954553.05803679
1,21,2,2,0,0,4,1716889.32461083,1992913.60774479
0,33,4,0,1,1,6,2136252.8603204,7264120.39542836
0,37,2,0,0,2,4,1479829.52279051,3786518.43601086
1,35,6,2,2,5,15,1816696.42054116,12256929.9436421
0,16,0,3,2,7,12,1544678.86034157,7788022.68570276
0,18,1,1,0,1,3,1362922.02109811,4067952.47260349
1,18,5,3,2,6,16,2137883.40135046,3505341.95114314
1,33,3,2,1,4,10,1603014.64874419,5847709.47129127
0,36,4,3,1,4,12,1478708.89086768,5858245.33748789
0,24,4,2,0,4,10,1910587.35558534,4568838.10491202
0,21,2,2,0,5,9,2053995.58810703,4458606.33251081
0,37,2,0,1,7,10,2125745.83211771,5582659.27869097
0,10,1,2,1,5,9,1921878.53800056,6112105.4530237
0,25,5,0,1,2,8,1520675.8427453,5317055.43402789
1,19,4,2,1,2,9,1535942.06698092,4289149.7663937
0,10,2,1,0,0,3,1267140.18059296,2787802.39405635
0,39,5,2,0,0,7,1753678.16718416,5110481.16255765
1,27,1,0,2,7,10,2505979.81792055,7066283.00172771
0,14,0,3,1,4,8,1669583.80818281,4402445.59199448
0,14,4,3,1,3,11,2668393.70947014,6769573.01540997
1,13,4,0,1,6,11,1730156.25708507,1941273.06450416
0,39,4,1,1,1,7,1449449.77926773,5939690.04520338
0,19,2,3,0,3,8,1706994.88471995,5606462.79686119
0,22,0,1,0,6,7,1560314.56397999,5686269.77033137
0,11,3,0,1,7,11,1996151.69099622,7479979.34021831
0,34,0,3,2,7,12,1871233.83018747,7722181.1200999
0,14,2,0,0,1,3,958327.516930552,1114445.52440413
0,16,6,2,2,6,16,2974420.38015792,8796898.24653382
1,34,2,3,1,6,12,2208865.46519427,3999330.22116309
0,21,3,2,2,1,8,1462399.09912769,5570111.69383824
1,14,6,1,0,2,9,2173875.60952465,4388786.00444365
0,11,1,2,1,1,5,1246154.31620546,2347895.09691534
1,12,0,3,1,7,11,1963921.51279781,8158977.034735
0,19,2,3,1,0,6,1149884.87268462,3982485.58171668
0,16,3,0,1,3,7,1792363.43184313,5835664.55530127
0,28,5,3,1,4,13,2548666.55953262,6678308.3745841
0,24,3,1,0,2,6,970279.292890497,1130542.27457995
0,25,3,3,0,7,13,2312326.803482,7278040.97306619
0,11,0,0,1,2,3,1114613.64270443,5080811.25046849
0,32,1,2,1,5,9,2123553.06973031,5542336.58270536
0,37,6,1,1,0,8,1693317.80652857,3152599.11138897
0,21,3,3,1,3,10,2048142.6577216,3999004.16833729
1,33,0,0,1,5,6,1340181.72484151,6827252.36278484
1,18,6,2,2,3,13,2694382.16403389,5615281.94301449
1,16,6,0,2,3,11,2128014.09451776,3386050.81889246
0,20,2,3,1,0,6,1420257.33624073,2603057.36890456
0,26,5,2,0,5,12,2627424.53040654,5783654.66831847
0,23,6,2,1,1,10,1976951.69112884,4496761.49443351
1,17,2,1,0,3,6,1846027.97675686,4029645.31987233
0,40,4,0,1,3,8,1532712.10137483,4407506.68392158
1,40,0,3,1,3,7,1626247.6840667,3408019.71106214
0,25,5,1,2,7,15,2713632.31213053,5808140.42508774
0,12,2,0,2,1,5,1428447.82034163,166770.818065744
0,17,4,2,1,5,12,1580444.02851079,4972221.18641466
0,37,3,0,0,3,6,1104890.62757186,5059404.7516082
0,38,6,2,2,7,17,2558066.01596874,9194137.71722012
0,15,5,0,2,5,12,3152118.20273276,5610800.85341927
0,23,0,1,1,0,2,1123829.94017075,4223918.72993621
0,36,5,1,0,1,7,1064110.50108549,4540337.79150412
0,38,4,2,1,4,11,1927955.9695376,7179439.74594736
0,18,3,3,0,1,7,1887490.6928165,4114023.8577676
0,24,0,3,2,4,9,2364433.53692899,6990336.61714218
0,15,3,1,2,3,9,1930300.2280602,4980386.57423915
0,22,1,1,0,1,3,1242970.3419317,6378523.06976576
0,39,3,1,2,6,12,2195365.03267742,6863236.01288477
1,29,6,2,0,2,10,2003733.74118292,6785333.10173146
1,17,4,3,1,6,14,1789328.51155288,9297722.52280576
0,17,2,2,1,6,11,2585641.8680457,7560942.62090387
1,31,1,2,1,5,9,1577434.60896138,4435049.44880929
1,27,0,0,2,7,9,2103822.49470836,5236590.97360188
1,36,6,2,1,5,14,2513052.85112485,4860065.16336276
0,30,1,2,0,6,9,2033513.17762761,4643349.56482132
0,30,2,1,2,3,8,1282023.72040425,4604907.18083931
0,21,1,1,0,5,7,1406056.6517415,1833372.06825713
0,17,4,1,1,6,12,2512580.52175399,8593995.61979229
0,40,4,2,2,2,10,1745899.23951997,4195731.18986737
0,21,0,2,1,0,3,2110872.10048706,3408836.40933046
0,25,2,0,2,6,10,2070368.23923887,7030366.46492396
0,25,2,0,0,7,9,1472354.00431853,7949421.92595542
1,23,5,1,2,7,15,3169901.58600302,5649603.45045849
1,33,5,2,0,7,14,2800040.16350136,8645462.41640878
0,38,0,2,1,0,3,1007875.91443357,5103342.70976989
1,10,4,3,0,0,7,1490650.54158654,4726071.05124868
0,36,5,3,1,3,12,2130219.76799524,4338800.95645373
0,32,2,1,0,7,10,2016028.00728768,6602124.6478448
1,21,5,1,0,5,11,1895979.72225146,4565275.53799284
1,16,6,0,2,6,14,2648256.2514135,3204848.61411548
1,18,6,2,0,2,10,1824738.73623267,6430568.7011706
0,39,1,3,1,1,6,1683116.65887476,2533758.01237391
1,24,3,3,2,5,13,1991433.49696512,6820338.7354288
1,30,5,1,0,3,9,1833085.77416021,4465546.53550746
1,39,1,2,0,5,8,1843214.13976287,5081057.64055136
1,29,5,2,0,7,14,2434311.68677332,5533695.40461055
0,20,0,2,2,4,8,1900360.63846079,4357570.56065486
0,11,0,2,1,5,8,1738223.58075492,3653600.86149169
1,40,6,3,2,0,11,2361243.44387357,7035066.25330307
0,30,5,2,0,6,13,2936451.04880184,7581691.30987836
0,37,2,3,0,4,9,1627463.82242554,8051641.20113216
0,18,5,1,0,5,11,2325689.02112498,6564529.9233711
0,12,6,1,0,2,9,2056499.09042127,6479150.7000629
0,27,0,0,2,5,7,1552490.2609336,6650846.51627032
1,25,5,1,2,0,8,1802480.85845393,7366778.57833378
0,12,1,3,0,6,10,1175077.13238993,4715219.31798945
1,23,0,1,0,2,3,1077493.22492559,4644713.79238393
0,27,0,1,1,4,6,1932273.13003713,2193900.52449356
0,12,6,3,0,2,11,2580721.75134791,5683465.64808438
0,14,6,0,0,6,12,2194181.11000915,5974872.92688598
0,21,1,1,2,0,4,1707657.42053946,5167722.49851894
0,13,4,0,1,3,8,2166211.92027606,8852488.31399367
0,28,2,1,1,5,9,1172326.17500236,5066161.26640449
0,19,5,0,2,5,12,2468450.7973446,3469377.25979906
0,19,1,0,1,4,6,1737298.20402018,5121269.83250271
0,21,1,2,1,6,10,2167309.69004527,1318742.05478465
0,21,2,0,2,1,5,1323280.34820032,3900163.47215546
0,34,4,3,1,2,10,2005467.03868004,3423133.56398899
0,30,4,2,1,2,9,2165968.06868901,6590635.4132331
1,30,1,1,2,7,11,1956608.38916382,9698076.24681484
1,15,2,2,1,6,11,2304067.32202156,8751071.10448886
0,31,0,3,2,5,10,2025370.85594567,4413935.09246367
1,39,4,1,1,1,7,1319321.72494064,6691109.7996979
0,40,5,0,1,7,13,2745701.54526706,4331000.07603007
0,12,1,0,0,6,7,1768678.89467085,5189652.41962479
0,12,3,3,2,0,8,1657074.27052427,4354362.59754657
1,31,2,0,0,7,9,1282328.42085913,6636188.69778666
0,29,6,2,0,4,12,2016784.58805538,7791152.49394773
0,19,1,0,1,3,5,1443729.45593009,5378579.87033284
0,18,2,2,1,2,7,1425018.5565097,2630168.55536608
1,35,4,2,0,7,13,2034000.02554923,2329179.68794658
0,39,1,1,2,5,9,1807528.44622241,4317972.23083354
0,13,4,3,0,7,14,2011750.41165322,5027443.08961144
1,30,5,0,2,0,7,2017194.18573581,5215554.87167903
0,10,1,1,1,4,7,1451698.95162042,3761208.88720098
0,37,0,3,1,3,7,1590349.53528017,6046359.04561524
0,26,4,3,2,2,11,2160115.08072406,7336841.75973306
0,26,6,3,0,4,13,2564380.85261753,6728622.25036198
0,13,1,3,2,0,6,1432721.8734511,5953584.7412547
0,18,0,1,2,5,8,1967071.82552969,5628978.31356747
0,37,0,1,2,4,7,1483639.88724011,5033807.08993427
0,37,5,2,2,5,14,2422716.09662268,7973758.85041289
0,29,3,1,1,6,11,2540561.62150079,6949275.33313024
0,24,1,2,1,5,9,1979455.34075449,5083905.32520519
0,26,5,2,1,1,9,2074768.51122146,7582654.77206231
0,31,0,0,0,6,6,1790817.10257494,4078931.52476148
0,33,4,3,1,5,13,2654298.2298312,7284615.48153119
0,18,6,1,2,0,9,1842397.84196849,6629013.14342672
0,25,0,2,0,6,8,1831523.81427866,8175278.80576771
1,15,6,1,1,6,14,1728599.12053075,7878854.89851869
0,13,2,0,1,1,4,1478280.31548109,3087707.34014771
0,18,6,2,1,6,15,2011554.9131644,5104881.48904064
0,25,6,3,2,3,14,2606298.11582809,9620525.06600922
1,19,0,0,0,7,7,1469249.21781231,6466561.10596797
1,23,6,1,2,2,11,2040552.56861131,4412123.62777302
1,27,3,1,0,2,6,1755959.28843082,4989871.69436485
0,14,1,3,1,0,5,1389341.48542071,6372355.49226093
0,12,0,1,2,6,9,1942751.99519982,6467864.61010116
0,21,5,1,1,3,10,1986883.25096273,4615288.43957259
1,14,5,2,2,4,13,2636679.64232022,6828125.78647591
1,40,3,3,2,2,10,1827298.02913227,3189557.22309259
0,21,6,2,1,3,12,2258323.9021728,8038417.46486146
0,37,0,1,2,7,10,1869829.65985936,3963751.4160848
0,14,1,3,2,2,8,1870132.18767997,6216761.69937774
1,27,1,2,0,7,10,2150050.09326477,5958761.88901324
1,13,6,0,1,5,12,2270638.27952574,5810027.21321534
1,14,2,0,1,1,4,1388332.26395145,2957203.42387796
1,34,4,1,1,7,13,2703498.23853401,8146234.59529267
0,25,1,1,2,2,6,1747155.30634583,6081752.85219502
0,29,6,2,2,7,17,2576970.37846513,9898716.37555557
1,40,4,0,1,6,11,2551974.02389017,10364831.4089605
0,21,5,1,1,3,10,1308652.43476089,5688794.18479873
0,11,1,0,0,2,3,1349802.51291422,3437139.47266197
0,21,6,0,1,2,9,1216548.34238117,6755433.72393077
1,10,1,1,0,1,3,1242178.09215381,5312550.76575716
0,17,4,0,1,6,11,2163119.30854978,6704518.49198198
0,13,2,0,1,3,6,1590373.8358143,4351410.31216033
0,33,0,2,2,3,7,1518425.94456107,4202227.59687992
1,14,6,0,1,0,7,1661546.62961282,1579045.76163706
0,23,6,0,1,4,11,1987177.21106345,5802039.64985567
0,14,1,0,0,3,4,994939.843499386,4186232.96429329
1,40,4,1,2,2,9,1908291.01945402,5755083.95216459
0,17,5,1,2,4,12,2044475.12482649,8246199.06064144
0,15,4,1,1,1,7,1685526.7295599,4814961.45274858
0,31,4,3,1,5,13,1948022.35234804,10331266.0657093
0,12,1,3,1,3,8,1466787.89412526,6651314.41943879
0,29,3,1,0,0,4,1375937.00500438,5029152.26279634
1,15,1,3,2,1,7,1790048.25741574,7340339.62862106
1,15,2,3,1,0,6,1855931.60971282,6434159.10792451
1,38,2,2,1,5,10,1723794.83319714,7304924.51052316
0,26,2,0,0,4,6,1766220.81339386,3793895.03315265
0,17,3,0,0,4,7,1453100.86358624,3752701.38309615
0,26,2,2,2,7,13,2375436.55155264,8430240.75113761
0,33,4,1,0,6,11,1790918.01629048,4935310.26413071
0,11,6,0,0,0,6,1507747.56418733,4738024.39247679
1,17,5,3,0,2,10,2127666.61110748,3137095.60563022
0,21,0,2,2,7,11,2323455.2491767,6042861.19485499
1,31,0,1,2,3,6,1470428.2758342,4227698.60022998
0,39,1,0,0,5,6,1239479.6859444,6357356.85317308
1,40,1,2,0,5,8,1669310.56730257,7117797.41547022
0,11,2,1,0,0,3,1386124.13323471,3480925.6035375
0,21,4,3,2,2,11,1888174.5574848,4782319.94229998
0,26,2,0,0,2,4,1709370.26353319,5112595.30114818
0,19,3,3,2,3,11,2511508.16029164,4931608.98566782
0,13,3,0,0,1,4,1101153.03171118,3016146.01416101
1,14,0,0,1,3,4,1353864.85218243,7338964.19623779
0,36,3,2,1,6,12,2588398.27486059,6357214.03164811
0,15,0,3,0,3,6,1511543.78745909,4968053.40328015
1,33,2,1,1,3,7,1565390.85397641,4494100.27354017
1,34,5,3,2,0,10,2323337.63661019,8197158.85922483
0,18,2,0,1,0,3,1200493.74595203,4833070.31566453
0,35,5,0,2,5,12,2301621.44129579,3977988.13028876
0,12,1,1,2,0,4,1564012.48528467,5667535.11180119
0,18,0,3,0,1,4,1094890.412214,2666604.21779722
0,20,0,0,1,4,5,1643873.7128441,5066108.92604279
0,12,6,1,1,1,9,1759363.3100367,4640698.34289546
1,23,1,1,2,2,6,1605105.01171733,4603147.93494545
0,25,5,0,1,5,11,1873937.61982238,5086686.77680231
0,34,0,2,0,1,3,1459384.89533242,7480915.79423424
0,35,5,2,1,0,8,1845526.93947631,9322622.59703516
1,29,2,3,0,7,12,2311859.45067536,5055173.76166569
1,20,3,2,2,2,9,1829548.62500344,4898849.69964767
0,18,2,3,1,3,9,1816639.67097011,4605093.6994045
1,38,2,0,2,4,8,2072510.16170706,6858436.62421498
0,34,1,3,0,2,6,1533972.33449396,5957889.87499819
0,33,6,3,1,2,12,2082886.72554528,3340538.15939587
0,37,4,1,1,0,6,1521801.52984724,6645775.1945767
0,15,3,1,1,4,9,2197096.74286097,6856391.8000486
0,33,1,0,2,6,9,1950221.35396278,6175166.93654468
0,27,6,0,1,1,8,1845729.90950386,7776148.88844474
0,22,4,1,1,7,13,2032728.66737275,4429446.58524139
1,13,1,3,1,4,9,1317662.77918478,2482806.0061426
0,21,1,1,0,4,6,1183984.79361825,2409310.20907691
0,29,1,3,0,0,4,1656567.38816987,3839234.90156868
0,19,6,1,0,4,11,1963325.9401483,7962809.14952411
0,12,2,1,1,4,8,1474733.41008845,6218540.65774649
0,13,2,3,1,2,8,1404801.54565743,6476864.16999972
1,34,0,0,0,2,2,814752.826864605,3912219.17214327
1,11,4,3,0,2,9,1865481.67795181,6743759.46882569
0,34,0,2,0,3,5,1365186.4939361,2384431.66972115
1,16,5,1,0,5,11,1748506.15291665,6081939.34962284
0,17,5,0,0,0,5,1740645.73095314,5150105.74825504
0,19,6,1,1,1,9,2059747.35634008,6540721.23745685
0,28,5,1,0,6,12,2252420.75976689,8118826.72527333
0,10,1,2,2,7,12,2783230.26712602,8030096.66068321
0,20,2,3,2,4,11,1888471.71023557,6837963.75385899
0,36,5,3,2,3,13,2702099.4715805,4898034.62695063
1,32,0,3,0,1,4,983261.30597994,3727416.34152542
0,25,6,1,2,2,11,2103747.41354337,7333110.43582239
0,17,0,0,2,6,8,1825889.56324732,4364330.31536063
1,35,3,3,0,1,7,1781090.31117797,4371678.3784646
1,38,1,3,0,3,7,2008358.28644992,6381523.89778366
1,34,2,1,1,3,7,1450926.7561707,6411201.1549534
0,36,0,2,1,1,4,1586018.85582723,2429270.93797038
0,25,1,0,0,0,1,954530.087843343,5643101.48803201
0,18,3,1,0,3,7,1781048.98006898,5464569.99492097
1,37,5,1,2,0,8,1891870.74021134,3881218.18872616
0,21,4,0,1,4,9,1827651.14060186,4750502.66565451
1,27,6,3,2,2,13,1997451.50973765,7006492.52665262
1,35,2,2,1,4,9,2232131.43218108,4806193.11121185
0,30,2,2,0,0,4,1318176.39093634,3093697.40223314
0,27,0,2,0,4,6,1665945.89463337,3714822.36634493
0,32,0,3,0,3,6,2053201.72630914,3265763.90651919
1,20,5,0,2,2,9,1829416.33311556,5525428.72588366
1,14,3,1,2,3,9,1977165.79925345,5861921.26496534
0,24,1,1,1,7,10,1920586.30593058,6059676.56232765
0,27,5,0,2,7,14,2432946.73176041,9198780.65931807
0,34,1,3,1,4,9,2274348.45533853,3649893.99838383
0,30,4,1,0,6,11,2616615.3445316,7522289.770168
0,10,0,3,1,4,8,1568575.75308592,3992959.54259152
1,21,1,3,0,3,7,1690546.85865896,3340758.58618931
0,37,0,1,2,2,5,1415893.90973089,1454285.14233913
1,39,3,0,1,3,7,1508257.22953532,7124378.08436709
1,35,4,2,0,7,13,2440233.45560509,5057679.58433903
1,17,1,2,0,0,3,724424.342443037,2829727.27711353
0,37,1,3,0,3,7,1397607.44144194,5572752.03847037
1,10,2,0,2,2,6,2090392.21494903,8682615.4829415
0,35,4,2,2,5,13,2567504.14729895,5205927.04789725
1,35,4,3,1,4,12,2300083.79095497,6281491.50440034
0,17,3,0,0,3,6,2098622.10473535,3848366.38834945
0,30,4,3,2,7,16,3174937.59169597,8310078.25131056
0,26,0,1,1,1,3,1673385.33235327,7596387.11464162
0,13,1,3,1,3,8,2090991.01590522,4387256.95476851
0,19,0,0,2,3,5,1963899.23661633,4521796.49526279
1,31,4,3,0,7,14,2404597.91860922,8431601.16623146
0,28,3,1,1,6,11,2424340.99417883,9102773.76720229
0,18,4,3,1,0,8,1489107.79744875,6623318.88292859
0,36,3,0,1,2,6,1555683.97070748,7346848.1003047
0,40,6,2,2,5,15,2671910.04322127,4958335.21172707
0,15,6,2,0,6,14,1887402.91719028,5703687.1541715
0,35,0,0,0,2,2,1554801.06205208,1740676.77065614
0,19,0,0,0,7,7,1725030.38965982,7057079.5408124
1,12,6,0,1,0,7,1342967.80652956,3849098.16669796
1,20,4,2,1,5,12,2247710.91682283,8010197.97048375
0,29,2,1,0,5,8,2217956.26687635,3401409.42523697
0,33,2,1,0,7,10,2467572.08153794,6283184.06233156
0,20,1,2,0,0,3,1012065.28215125,4180892.93711542
0,26,3,0,1,0,4,1451924.01155603,3121851.79397608
1,16,0,2,0,1,3,1408335.00267581,4748537.38969827
0,25,6,0,2,0,8,1586991.41428476,6736295.93850212
1,25,4,3,0,5,12,2234817.45487287,7039710.56513932
0,14,6,0,2,6,14,2186723.69398645,7688241.68561293
0,26,2,0,1,2,5,1242580.34257076,4850197.2489194
1,40,0,3,0,5,8,1384448.8006224,4822539.61141842
1,27,6,0,0,2,8,2247325.37316441,6336759.07430082
0,31,4,2,2,6,14,3255779.43501849,7980780.23711515
0,13,4,0,2,4,10,1804681.46562881,3974804.20265192
0,15,2,1,0,2,5,1299706.98989638,2591505.21207018
0,27,6,0,1,5,12,1992081.0494636,3278880.51514595
0,22,2,1,0,2,5,1691930.0441283,2923202.76015258
1,28,5,2,1,2,10,2036455.88107195,5469863.31731534
0,24,6,3,1,2,12,2213394.36588409,9144052.20624006
0,24,4,3,0,4,11,1865427.48012112,7085438.8157758
1,21,3,2,0,3,8,1934867.53058117,4973312.16718235
0,28,5,1,2,6,14,2583172.41884525,6567312.85229309
0,25,2,0,2,7,11,2462007.3370631,6466731.71257921
0,19,0,2,1,0,3,1046401.91821702,3047626.01334784
0,17,2,1,1,0,4,1182013.79330132,3124357.89834727
1,37,6,0,1,2,9,1837416.44178889,4795458.68759877
0,16,0,1,0,2,3,1991719.22299943,5318119.84486074
0,28,2,0,2,6,10,1901434.86433892,4622582.31496236
0,19,3,3,1,6,13,1896193.32963572,5512908.72799178
0,32,5,3,1,0,9,1932124.46170329,4555021.1980497
0,14,6,2,1,5,14,2262454.18207888,6617689.14897624
1,17,5,2,0,2,9,2051392.55161092,7311980.81340797
0,20,6,0,2,4,12,1903854.40962664,8266597.38440694
0,21,1,3,1,4,9,1786252.62799645,9370687.96532271
1,18,3,3,2,0,8,1682175.51470746,5456940.31994479
0,25,0,0,0,3,3,1131893.67012786,1716332.61996051
0,27,2,2,0,5,9,2012365.79848593,8397363.10267203
0,36,5,2,0,3,10,2095604.50020563,7981213.68448883
1,37,4,2,1,7,14,1973092.13294598,7571252.19910099
0,37,0,0,0,5,5,1509695.20296395,4834738.09980493
0,24,6,2,0,1,9,2114087.02353156,7019340.35957807
0,23,2,1,0,0,3,1185582.66180711,5163138.12568762
0,17,5,0,1,0,6,2023204.91114152,6987744.03746253
0,26,2,3,0,0,5,1891445.01507187,5657400.56285204
0,36,3,0,1,5,9,2045041.25865801,7136855.89669991
0,24,4,0,0,6,10,2155516.67707181,6545432.01490732
0,23,4,0,0,5,9,2200130.76032617,8841886.17279298
1,16,5,2,0,4,11,2228492.33494884,4583299.96831176
1,39,0,1,2,1,4,1657179.6381982,3528098.71651944
0,23,3,1,0,0,4,773930.559088344,5409169.64306451
0,27,0,0,2,0,2,1153079.31468694,2007320.80681198
1,36,6,3,0,6,15,2781175.38965206,4819049.98408083
0,27,2,3,2,3,10,2079034.43198522,6218432.19098348
1,34,0,0,1,4,5,1475451.37160481,6054401.98643426
0,12,0,0,1,3,4,1355421.12942637,3626194.4372238
0,32,3,2,2,4,11,2077459.22449114,4961639.88726472
1,21,0,2,0,7,9,1213654.45697077,8128841.98787409
0,22,2,2,1,6,11,2370856.74768907,4006971.09889367
1,39,2,1,2,6,11,2179506.48263825,5707478.55195957
1,32,6,0,1,0,7,1319331.31267172,5172689.00844209
0,26,3,1,0,2,6,1904438.46776993,2373366.68300437
0,18,2,1,2,1,6,1289977.30713822,6138512.1817119
0,25,4,2,2,5,13,2523709.36318884,8089856.72898354
1,32,5,1,2,7,15,2389277.91314507,8044810.03786689
1,11,2,1,0,5,8,1874001.27435625,4475434.44800846
0,37,1,1,1,6,9,2168506.20363233,7915272.38957267
0,36,6,3,2,1,12,2114799.27196782,8589442.38183118
0,18,4,2,1,0,7,1736179.91383844,5647676.90208794
0,34,0,0,0,5,5,1330779.44151909,7900873.17059515
0,16,0,3,0,7,10,2203995.12962215,5182968.23556956
0,20,4,0,2,3,9,1660955.97110741,6503467.14017054
0,37,0,2,1,7,10,1585447.31487599,8337413.15117928
0,36,0,2,1,4,7,1135038.90761149,5610304.59593212
0,34,2,1,2,7,12,2274491.47318205,3341810.91793256
0,30,2,0,2,6,10,1897577.57620768,8379821.75267826
0,22,5,3,0,1,9,1947555.67995878,4372234.51928549
0,20,5,0,0,6,11,2141938.96180124,8207466.36572943
0,11,1,3,2,0,6,1636195.74579556,3452751.38886433
0,11,2,3,0,3,8,1804029.86906383,2010911.8893531
0,22,4,2,0,6,12,2778648.15596461,6793179.38011444
0,19,3,1,2,7,13,2630501.6033684,9274684.14517745
0,27,4,1,2,4,11,1120576.27291155,11114685.6263042
0,18,6,2,2,7,17,3417444.35768546,11813545.2995661
1,28,4,2,0,5,11,2199512.58790937,9388962.08784286
0,15,1,0,2,4,7,1774563.97297136,4867230.18096758
0,19,5,2,2,5,14,2480429.75088481,7612977.48589335
0,27,2,1,1,3,7,1886919.45242177,4971525.29057341
0,23,6,0,2,0,8,2166221.71505762,6806073.64550067
1,20,3,2,2,3,10,1558585.38494747,6492997.82105024
0,26,6,2,2,4,14,2277623.56347763,9155889.76818173
0,27,1,2,0,2,5,1741127.27385121,5605629.93108503
0,34,2,2,2,2,8,2110098.25113195,7601481.7385014
0,13,3,1,1,7,12,2646907.09825132,4372792.69819932
0,21,4,1,1,3,9,1809049.05326833,6405664.26084508
0,21,2,0,1,7,10,1985626.38103087,4163776.73417932
0,12,2,2,0,4,8,2116835.7812277,7674176.99253916
0,27,3,0,1,4,8,1377692.50715594,6568804.49962586
1,19,3,2,1,4,10,2137364.41122582,3187387.66025017
0,36,3,0,0,2,5,1557937.66700684,7093935.30230531
0,26,4,3,1,2,10,1618198.8013969,6187396.53672002
0,36,5,1,0,5,11,1895128.54975666,11260626.0610932
0,14,1,0,0,4,5,2082994.55960067,4829737.33188823
1,23,0,1,1,4,6,1669422.61142825,3205822.46765449
0,15,5,1,0,2,8,1846521.93007595,7232123.77319319
0,20,1,2,2,1,6,1711226.71238994,3791006.33346526
0,10,0,2,1,5,8,2229377.63074699,6902336.95476579
0,28,1,3,1,0,5,1319944.48154136,3034721.49850904
0,33,2,2,1,2,7,1523287.2360411,3935678.75663815
0,12,4,3,0,0,7,1932994.11335255,3438240.47751716
0,34,4,3,0,6,13,2791276.69373115,5943591.58005805
0,24,2,3,1,7,13,2975634.62826367,9789491.83132602
0,15,5,3,1,5,14,2262634.34366573,5417422.4349858
0,35,2,3,1,7,13,2671637.77137353,4128622.59211195
1,13,2,2,1,0,5,1429451.83596224,6496628.20912205
0,18,3,3,0,0,6,1105197.81689262,5013045.2458106
0,31,1,3,2,6,12,2250762.55843859,7716731.48065689
0,38,2,3,0,3,8,1694525.79715389,5017523.271811
0,18,6,3,0,0,9,1634164.63201958,3468950.21756818
0,18,5,0,0,3,8,1493099.35153202,7120294.71292416
0,25,3,3,2,6,14,2674603.62746858,4086923.80494073
1,17,2,3,2,2,9,2027783.69931075,6615615.43981954
0,27,1,3,2,2,8,2364262.13937519,5715917.39571404
0,26,3,3,2,2,10,1938988.7125895,5535576.16780926
0,15,4,0,1,4,9,1747952.67842525,7292997.87425094
0,25,3,0,0,6,9,2172923.87347776,7203203.17887429
0,25,5,2,1,5,13,2123800.93198449,6400746.71193494
0,16,5,1,1,5,12,1608627.80499236,5461441.37945881
0,38,0,3,2,2,7,1592784.64715586,6289216.46594617
0,33,2,1,2,5,10,1921811.96581495,6156524.55361231
0,40,1,0,2,0,3,1121183.79789401,4189701.13761472
0,32,4,1,0,4,9,1954039.86953278,4629313.55554086
0,28,3,2,0,0,5,1723859.836769,4218982.87953484
0,20,5,1,0,3,9,1768939.26707362,5690570.89830721
0,24,3,1,0,2,6,1382610.3236015,5896634.48828606
1,15,3,0,0,7,10,2391307.55806704,7030692.25677634
0,24,1,3,0,4,8,1732105.04529303,7264760.95677141
0,27,6,2,2,6,16,2565738.28054661,5269254.27022426
0,32,1,0,0,5,6,1453746.18884358,5255220.78775448
1,35,4,3,1,2,10,2008087.53250695,6619545.74479275
0,24,5,1,0,4,10,2019501.95804915,5881307.3613923
0,39,1,3,2,7,13,2268194.42038398,5322488.53616993
1,23,0,3,1,5,9,2030705.54300716,3955563.90856087
0,13,4,2,1,3,10,2199471.0473932,4055734.73807108
0,28,0,1,2,6,9,2197440.28211439,9265858.76514527
0,16,5,2,1,4,12,1964692.74647189,11101887.2159692
0,30,2,1,2,5,10,2018332.01571806,3984523.92613892
0,31,1,0,1,2,4,1357726.80316031,5666928.75427735
0,39,4,0,2,5,11,1719002.83491132,4152712.61205703
0,21,3,3,1,4,11,2078549.30250203,2282002.68859632
0,31,5,1,0,2,8,1761118.01977892,4163314.09146087
0,13,3,1,1,2,7,1699402.51510636,7724802.56106319
0,34,2,1,2,2,7,1897703.62489486,7453752.11829208
1,19,4,2,2,3,11,1860765.90032282,8691889.44787496
1,23,3,0,2,3,8,1437008.50715274,6904759.85952259
1,12,0,2,2,0,4,1588604.31633906,5123299.87958443
0,16,6,0,1,4,11,1955285.36474747,7614652.69567839
1,28,5,3,2,5,15,2320692.36850482,5691140.6422475
1,18,4,1,2,1,8,1349088.79222288,3505286.85618096
0,29,4,1,1,1,7,1497564.47777379,8349157.26768375
1,28,3,3,1,6,13,3254293.07116852,9229043.05464131
1,29,5,3,0,0,8,2135868.69127695,2130513.72133272
0,18,0,2,2,2,6,1309759.22135615,5644363.00525958
0,34,6,1,1,5,13,2012702.650267,5043886.23005328
0,12,2,0,0,2,4,1509654.44170645,6116965.20814581
1,18,3,1,1,7,12,2272129.11931664,5404205.37273236
1,22,4,0,0,1,5,1414613.36659245,5699664.61869022
1,25,4,0,0,0,4,1901473.44941926,5047522.82465645
0,40,5,0,1,7,13,1872839.94614462,5233466.16059287
1,16,6,2,1,1,10,2059605.04028159,7262868.67925839
0,24,1,2,1,6,10,2024446.06908338,3801758.1694301
0,40,2,2,0,6,10,1083633.49483816,7281688.18474371
0,10,5,3,2,6,16,2250165.95872572,5606148.55524082
0,11,2,3,0,0,5,1468870.69804676,622043.543814749
0,40,5,0,1,1,7,1467546.51786127,6153194.09205981
1,22,1,2,2,2,7,2324189.49485505,5623478.82220552
1,19,0,3,1,3,7,1385908.70368531,5813580.80466129
0,18,5,1,0,0,6,1665508.19994808,1665508.19994808
1,23,5,2,0,6,13,2625178.22632512,6926594.66587298
1,39,4,0,2,4,10,2241485.5029358,3852515.08970648
0,11,2,0,0,1,3,1284448.65192978,3536570.36950614
0,14,4,1,1,4,10,1550542.68319838,2899758.35563358
0,35,3,1,1,0,5,1969950.3724049,1152956.26508332
0,11,6,2,2,7,17,2730998.69178475,3898412.60149474
0,26,1,3,2,4,10,2094012.30749219,5078418.1415711
1,17,6,2,0,6,14,1625292.32575151,6363142.96935187
0,32,0,3,0,6,9,1795649.89301611,6644556.57226566
1,33,2,0,1,6,9,1641913.86991349,9385194.77180509
1,32,1,0,2,7,10,2148311.72144612,7817081.17557902
0,27,2,0,1,7,10,2093142.1601954,6127997.46364467
0,38,0,3,2,4,9,2443229.46486678,5415300.67117632
0,30,4,2,1,3,10,2350279.85307443,5536999.28226423
0,31,2,0,0,2,4,1508636.75200311,2893886.69470744
0,40,6,1,2,5,14,1844782.95507953,7048695.252839
1,40,4,3,0,7,14,2874098.70444043,4270392.6559769
0,33,5,3,2,3,13,2343053.00772883,6811680.33082725
0,24,0,3,2,6,11,2161087.05705831,8543100.26373721
1,34,4,0,0,6,10,1992410.24988904,2525979.431513
1,10,3,2,0,1,6,1927886.79955816,4846624.70134625
0,11,0,1,1,6,8,1831289.71472499,6604541.19236621
0,38,5,1,0,5,11,1474075.91022121,10780482.5366418
0,38,4,2,0,5,11,2318344.91860823,5261432.52423778
0,11,6,0,2,4,12,2197880.75181988,6774267.60352025
0,19,3,0,1,7,11,2730865.20713627,5341803.24668453
1,30,4,0,1,6,11,2469447.1628788,5786140.95902052
1,34,0,2,2,6,10,2136664.40164049,4518717.26664215
0,28,5,1,0,4,10,2328334.58299102,3961907.26092841
0,23,2,2,0,3,7,1679745.76247854,4924521.68939532
0,16,6,3,1,7,17,3161441.74449826,10317128.5753074
0,29,1,1,1,7,10,1927586.13894528,7262267.07364629
1,30,1,0,0,6,7,1733167.06317418,6763676.15161584
0,27,5,2,2,3,12,1656175.12305045,7184742.01342634
1,32,5,3,1,5,14,2694043.55234072,2197380.6955096
1,18,0,3,1,5,9,1929322.38667438,9604750.27861496
0,27,5,0,1,0,6,1518798.00385484,5403660.81102412
0,28,3,2,1,6,12,1700448.91542503,8837552.04861813
0,28,3,2,2,4,11,1404085.34035606,6583640.3164812
0,14,2,1,2,7,12,2081799.28910175,5518155.61616585
0,17,0,1,1,5,7,1594504.7296467,1639184.16737911
1,19,6,3,1,5,15,1909653.36037322,7022944.78935557
1,14,4,2,0,6,12,2761768.4457391,6199939.5027822
0,18,5,1,2,4,12,2262889.98191865,7478714.71479166
0,31,5,0,1,1,7,2239111.99072837,4558732.97472641
1,11,4,0,1,4,9,2235743.24761357,4569366.06942205
1,36,6,1,0,3,10,1545899.96242452,2321839.47903583
1,20,5,2,2,4,13,2528642.29984557,5104385.6503343
0,12,3,1,2,6,12,3102461.98986795,10035129.4710487
0,40,1,3,0,4,8,1609475.18912516,5928328.14916643
0,36,3,1,1,5,10,1790840.72895227,5905555.75285891
0,25,2,1,2,3,8,2172720.47941659,3769207.42531621
1,20,3,3,1,0,7,1812550.56046562,5824629.9752446
1,33,5,0,0,5,10,1490163.30292925,3881295.55319222
0,39,6,1,0,7,14,1903051.66718722,10614152.7954142
0,39,0,2,2,2,6,1580216.5583574,4553316.71568441
1,11,5,1,0,5,11,2042937.3144127,7963102.02663804
0,10,2,2,0,0,4,1268430.6600109,4567571.33425426
0,37,0,1,2,1,4,1355390.90720046,5143514.82369717
0,31,5,0,0,2,7,1719637.46073632,4090119.43769271
0,33,5,2,0,4,11,1972099.00696087,7233985.44834722
0,35,3,1,0,5,9,2036893.41636286,3094850.05035585
1,30,1,3,1,0,5,1508541.53463887,3658556.15538016
0,39,1,2,2,6,11,2272923.82693385,4279107.28523055
0,35,6,3,1,2,12,2117448.43952906,6713118.32606401
1,15,0,3,1,4,8,2041371.44146645,6414730.16065277
1,21,6,2,1,7,16,1944373.43053195,7809680.3305859
0,33,1,0,1,5,7,1531116.56689817,5760671.02253719
0,27,3,3,1,0,7,1485177.54356755,7418277.1663683
0,13,6,3,0,1,10,1900258.40952655,2518183.18042162
0,27,1,0,2,6,9,2114981.29611973,8032519.09449955
0,39,3,0,2,5,10,2000837.36824855,4999595.57523024
0,30,3,0,2,5,10,1807399.35968821,9087498.23627353
0,38,5,1,2,1,9,1939196.13141145,7936364.9665118
0,24,2,1,1,6,10,2294460.98524153,7135664.83834753
1,10,5,0,2,6,13,2308438.0539897,5289890.14257552
0,33,0,1,0,0,1,1282954.87764699,1974478.63605285
0,28,4,0,2,6,12,2544616.52493553,6520131.40365025
1,26,3,3,1,2,9,2120261.62918929,3652663.29624665
1,28,5,2,2,0,9,1764536.58432226,5574483.28677913
1,24,1,1,2,0,4,900839.672702279,3698229.34149522
0,18,3,1,1,6,11,1889503.6134305,6585050.83836672
0,30,6,3,2,5,16,2879727.7667948,8313582.94382402
0,35,0,0,0,1,1,1268739.80991035,3070920.98184649
0,10,5,3,0,0,8,1997498.0247885,6112183.09433182
0,27,5,1,0,3,9,1921465.78853426,6204668.20848309
1,12,4,0,0,0,4,1352459.99019719,4174670.54554737
0,28,4,1,2,6,13,2005236.25045335,5742549.20864883
1,12,6,3,2,0,11,2071072.89366752,6270937.24632374
0,24,5,2,0,4,11,1941548.10253153,7871792.98394025
0,31,1,1,0,5,7,1189518.39687958,4789833.76267388
0,19,0,2,2,5,9,1945812.45612758,5934150.79419661
1,38,6,3,0,5,14,1751342.60309785,8567856.74840024
0,40,5,2,1,6,14,2168813.96950034,7174271.53294453
0,12,1,3,2,1,7,1618969.05321764,4509231.51783846
0,17,6,1,2,3,12,2354585.8869417,6794673.41412728
1,30,5,1,0,0,6,1650526.21631866,5744215.76191744
1,24,4,0,2,0,6,1639555.53342659,1941308.2793265
0,30,6,3,2,1,12,2348273.63360741,8449101.54155736
0,15,1,1,2,3,7,1722322.45357617,3470793.72345779
0,32,1,0,1,0,2,1338975.00668112,2500322.02499525
0,37,3,2,0,0,5,1241588.68185115,4535888.20839716
0,19,4,2,0,5,11,2285198.25905175,8899198.68417207
0,28,2,2,0,7,11,1603908.71726782,7591690.51155719
0,21,3,0,1,3,7,2021432.18447724,3258709.40633583
0,15,0,0,1,1,2,1599948.63426099,1279617.48977074
0,16,3,1,2,4,10,1699313.22478055,7305663.76406939
0,24,3,1,1,4,9,2113440.78558161,4488191.5768468
0,21,1,3,0,5,9,1375871.62986966,5914432.84015414
1,19,4,2,1,2,9,1592487.19179052,6813092.54201394
0,36,3,2,2,0,7,1756284.73980076,3189123.91498101
0,35,2,0,1,7,10,1995147.67287512,6907347.6591141
0,24,5,3,2,1,11,2348434.9127126,4506146.46511161
0,25,1,0,2,2,5,1257163.61841702,5161750.97408581
0,34,4,3,1,3,11,1836100.58347221,5162733.80137969
1,13,2,2,1,0,5,1354221.7229004,7306525.74285345
1,14,6,1,1,6,14,2327070.72353074,9166003.05657268
0,14,6,2,0,0,8,1891968.86881544,5242591.44058783
0,40,5,1,0,2,8,1675281.7571837,4414427.71287227
0,24,4,0,1,2,7,1893228.93769945,7451029.67580725
0,25,6,3,2,6,17,3526829.19013645,11726125.3414811
1,16,2,2,0,3,7,2114688.47302264,5994054.05000097
0,27,5,3,2,7,17,3364429.61189162,4960264.17490711
0,28,1,1,0,3,5,1936113.79888061,3418517.31003742
0,36,1,3,1,1,6,1765702.5661471,4935825.91464946
0,14,2,2,0,5,9,1357599.50261208,4702948.76209977
0,20,6,0,2,7,15,2240057.67397238,8967043.0665796
1,23,4,1,1,3,9,1951702.79758489,6567091.24120569
0,32,3,2,0,5,10,1482953.63077202,7380796.29458892
1,27,5,2,0,5,12,2321705.45800982,8736894.22097818
1,37,3,3,2,1,9,2074235.37317068,5444285.19395496
0,28,3,2,2,1,8,1619365.07044534,4857641.35802613
0,35,6,1,1,5,13,2453980.33860661,6088163.99348593
0,19,3,0,2,0,5,1957287.8837939,3725048.41694189
0,40,1,3,1,2,7,1375136.50264278,6209988.38251842
1,36,4,1,0,2,7,1903977.01296595,1586002.16006162
0,34,3,1,2,5,11,2348404.66075037,7388149.43554664
0,40,4,3,0,1,8,1437381.36663841,7276340.31473211
1,19,0,0,1,7,8,1916285.27996723,7849967.91403524
0,39,5,1,0,3,9,2188237.59207383,6130407.00610602
1,34,0,3,1,3,7,1601515.67953127,5653617.35361088
0,10,4,0,1,0,5,1423482.33061293,5090355.35559693
0,34,2,3,2,5,12,2190468.33343741,8848428.53667576
0,10,4,0,0,0,4,1557244.86772482,3402738.14369115
1,24,4,3,0,6,13,2257974.15111824,5251301.26544944
1,11,2,3,0,1,6,1355295.83804889,4398997.76117701
0,17,4,3,1,7,15,3306281.14023578,4913775.90156058
0,28,2,0,0,3,5,1257042.21563699,3876314.07915214
1,25,0,0,0,7,7,1763982.73089198,7252215.41904666
0,19,5,0,0,1,6,1587791.29544339,4939322.93380248
0,27,6,1,2,3,12,2317404.61760196,4950210.8725219
1,32,4,3,1,0,8,1423826.91945591,5036927.72683294
1,31,4,0,1,5,10,1741511.80279819,5854874.49928514
1,36,3,0,0,4,7,1945757.69398907,4721012.9802829
0,23,1,3,0,4,8,1919346.28470878,3427177.94964274
0,25,2,3,1,1,7,1354219.00626349,4595048.95729895
0,37,5,2,1,5,13,2608045.26986108,10502520.6662264
1,26,5,0,2,5,12,1652928.03462672,8909206.83391374
0,36,4,2,2,6,14,2315910.64305042,7064820.79478997
1,37,4,2,0,2,8,1160034.10657413,3340723.82912248
0,33,4,0,0,3,7,1642606.01893752,4848950.65667118
0,39,6,1,2,2,11,2633430.49956427,2584897.03548694
1,13,0,3,0,3,6,1456701.40309077,5216262.78501258
1,24,0,0,1,4,5,1799497.6408657,5062246.99227664
0,23,5,1,1,5,12,2782371.52665727,7420044.6334938
1,17,3,1,0,1,5,1323740.65909715,3322099.24007809
1,20,3,0,1,2,6,1201332.83927165,2962342.94471603
0,37,5,0,2,6,13,2270654.1702703,7058731.09105453
0,36,5,3,1,1,10,2461271.55691674,5689714.1566159
0,15,5,0,0,7,12,2615622.6634336,5331536.12007027
0,33,6,2,1,1,10,1646694.14067786,3953317.2704224
0,37,5,3,1,3,12,2033229.46735948,2213893.45974874
0,11,2,3,1,4,10,1654044.24030238,7340073.25402271
0,12,3,0,2,1,6,1446345.31261189,7132578.96963869
1,25,1,0,1,6,8,2303766.69864778,5771620.76456607
1,31,2,2,2,3,9,1723062.53275825,5254899.11007962
0,30,6,1,0,0,7,1813488.51098447,4731790.84460216
0,39,4,3,0,4,11,2271424.9288252,4383475.89486866
0,24,5,0,0,5,10,2108345.68736256,3198703.67741187
0,25,3,1,2,1,7,1373749.00336713,4924043.62802577
1,27,3,3,1,7,14,2761962.65956293,6757144.72344154
0,18,4,3,1,6,14,2694817.18148302,8763797.41740933
0,20,6,0,1,1,8,1301151.89262137,6141097.44484882
0,36,5,1,0,5,11,2388930.55598585,5040960.25603287
1,14,5,2,0,0,7,2247714.10167271,6398369.88226283
0,29,3,1,0,5,9,2657370.28516344,6048178.82231717
0,11,0,0,0,7,7,1919167.58470166,4462438.06163957
1,22,5,1,2,3,11,1521116.98967952,7292770.57954854
0,13,2,3,1,6,12,2277903.68883517,4803388.51065029
0,30,2,0,0,4,6,1386614.69689475,3962852.37032878
1,35,6,0,2,2,10,1459049.01662905,10308210.8495731
0,21,4,1,0,1,6,1751130.71081903,4923897.75791743
1,37,3,2,1,7,13,2582373.49209189,1554926.69750082
0,31,2,0,1,4,7,1663156.66757832,8008389.55678979
0,28,0,1,0,0,1,1174638.94901366,3569147.54361971
0,30,5,1,1,0,7,1765355.53356478,3806010.83512896
0,34,1,2,0,4,7,1671936.37502201,4796822.99189025
1,31,4,2,0,3,9,2358747.51886474,5845990.01050679
1,20,3,2,2,0,7,1873702.27096548,6819341.10046623
0,21,6,0,0,4,10,1940804.12648094,4965072.22360308
0,27,5,3,1,1,10,1991550.52987742,7221177.18894918
1,39,6,1,1,2,10,1144380.01925369,4034338.21287752
0,19,3,2,1,0,6,1616164.76157256,4731879.49583233
1,33,1,1,2,7,11,2296962.41933417,4890605.74849784
0,12,4,2,2,1,9,1555324.48915821,2669616.72592596
1,30,1,3,1,0,5,2114294.00781166,3723558.54281319
0,36,2,2,2,6,12,2321586.27517619,8823700.5526548
0,39,6,3,2,6,17,2129474.67419523,5879370.38213438
0,38,4,2,2,2,10,2297509.79254976,8097453.64474011
0,22,1,2,2,2,7,1904714.08423863,2897494.20141065
0,19,5,1,0,2,8,1676897.7231141,8861638.25403302
1,37,2,0,2,4,8,2256145.91107525,5833539.68665382
0,31,2,3,2,0,7,1775038.01370349,3094025.4507134
0,12,2,3,2,5,12,2547137.66670295,7226786.94582144
0,23,6,0,0,7,13,2386055.46165668,5077273.19995194
0,20,2,0,0,2,4,1311154.76423511,3189901.80442764
0,19,6,3,1,3,13,1876019.43306391,5770123.6217808
0,19,0,0,1,3,4,1657308.12489092,6404851.96289253
0,15,2,3,0,1,6,951582.688351557,6478748.51563751
0,35,4,2,2,3,11,1868535.50077483,5720426.13505463
0,11,3,0,1,1,5,1184324.7462201,7400711.06081378
0,11,0,0,0,7,7,1631210.07356877,7090542.15219153
0,23,5,0,1,3,9,2575053.96643576,5706833.22359406
0,23,1,0,0,1,2,1101822.82155565,407407.400457132
1,26,0,1,0,1,2,876098.54522499,3066111.3391019
0,20,5,2,2,1,10,1352119.17607733,5339339.96767017
0,35,2,2,2,1,7,1805956.32255125,6051972.96090843
0,12,4,2,2,1,9,2010370.79713688,5707182.89286885
1,32,1,3,2,5,11,2630963.90605463,6640809.21279971
0,17,1,0,1,4,6,1661366.21018222,6761998.00373388
0,28,3,0,1,1,5,1553164.91344144,4709875.18962341
0,33,3,3,1,3,10,1900976.00541093,3368398.00130196
0,18,5,1,1,6,13,2823012.93680509,7228086.48141389
0,25,1,0,2,0,3,1263013.58788366,3213985.58291299
0,26,4,3,2,0,9,2090805.60289687,7034523.64029779
0,14,5,1,0,1,7,1216706.60881506,6059128.05877385
1,17,6,1,1,5,13,2209400.58734255,5518941.84729939
1,18,6,3,1,3,13,2428027.59496303,8154507.50160563
0,17,1,0,0,6,7,2215438.83376202,8762198.37985933
0,33,4,0,1,5,10,2116176.40585614,7319215.21235937
0,28,1,1,0,2,4,1751064.39253528,5276103.39910655
0,32,3,3,2,4,12,2122214.60475283,5481683.95826157
0,20,4,0,0,7,11,1933006.97442447,6165521.30052193
0,30,5,3,0,6,14,1646615.72171747,4979989.77965992
0,28,3,1,1,4,9,1903482.77736955,4435737.59470924
0,28,0,0,2,5,7,1807906.13659763,6026754.39758608
0,32,5,1,0,5,11,2426086.78041445,5209043.36838989
0,10,0,1,2,1,4,1340406.92998794,5331318.81472041
0,40,0,3,0,7,10,2147264.52576987,6099468.02194558
0,24,0,2,1,4,7,1739221.31559505,3090932.96849578
0,30,0,3,1,0,4,1116983.47097301,4211907.25033408
1,12,6,0,0,1,7,1466847.13784319,4718045.54822089
0,30,6,2,1,6,15,2614495.68022489,5050843.62649
0,23,5,2,2,1,10,2387035.28642557,8795181.67457594
1,15,1,3,2,0,6,1745846.98743975,3645591.84483347
0,11,3,0,0,0,3,1295292.59870093,4276615.51923116
0,20,1,3,1,0,5,1420142.20131902,4503553.5673579
1,27,0,1,2,2,5,1111826.65352835,5532804.07646121
1,32,4,3,2,5,14,2281596.07644165,2161389.86537066
0,19,2,1,2,1,6,1815494.43968616,4842989.32767575
0,34,3,3,0,4,10,2174365.48962251,1379586.10894566
1,20,1,3,2,6,12,2454973.13282355,5934465.53820653
1,32,0,0,0,2,2,968950.541869048,3402513.81382213
0,27,5,2,1,1,9,1753766.20945303,5811409.53219194
1,14,2,1,2,2,7,1812065.82347584,4709663.38097189
1,28,2,1,1,4,8,2095163.88772505,5288544.19027005
0,23,3,3,2,6,14,1425178.12435321,10070134.7916039
1,31,6,3,1,0,10,1827461.93390396,5738219.65736541
0,21,0,2,1,6,9,2181262.44358409,7333609.675519
0,32,3,0,0,6,9,1914832.7896353,6650535.57640498
0,15,6,1,2,5,14,2639554.05927277,5893328.0482748
0,32,6,3,1,5,15,2227750.80145666,4833434.51731976
0,21,3,1,2,6,12,2491446.41161832,5999245.63581594
0,34,0,1,1,5,7,1267570.01763771,3805745.59797139
0,18,6,1,0,5,12,1776133.37109736,4686293.32961386
0,26,6,2,2,5,15,1712671.35826367,6472597.80068877
0,30,0,0,1,6,7,1586684.2464585,5498743.80746838
0,16,0,2,2,1,5,1869749.99737546,6404620.99376483
1,29,1,3,2,6,12,2684342.55362374,5950867.64642366
0,19,5,3,0,4,12,2019571.95162686,7318295.55402596
1,38,1,3,2,2,8,1732965.48206296,6632944.43231636
1,32,5,3,1,3,12,2278401.18931338,6182594.49156543
1,36,0,3,0,5,8,1726872.81181037,3829791.71244138
0,37,3,1,1,1,6,1438425.5568831,5958476.30447314
0,40,5,3,2,6,16,3269941.61730368,7498662.79953342
0,32,4,1,0,2,7,1643330.13128085,8471391.4535134
0,21,1,3,0,7,11,2082692.59302987,7781903.48209438
0,31,5,3,2,5,15,2735230.10941082,7233669.00553553
1,24,4,0,2,3,9,2228837.15891454,5993409.09426029
0,28,4,3,2,5,14,2510055.15681416,10005753.309411
1,20,4,1,2,4,11,2455726.85794293,7057937.5690349
0,20,1,2,2,7,12,2358367.3010264,9739747.52328843
0,17,2,1,1,6,10,2103343.09319704,3323318.59079667
1,40,5,1,2,4,12,1864961.10439304,7302314.71398524
0,40,5,1,0,7,13,2315026.84608549,7043159.21683711
0,36,2,3,2,2,9,2180112.49374744,3567982.59959422
1,38,2,0,2,3,7,1559599.77294545,4134982.29843183
0,15,4,2,1,3,10,2184843.73320638,3930555.84438477
1,15,2,0,2,5,9,1829013.95157887,8688356.27754787
1,11,1,1,1,5,8,1917089.88068223,4286204.11750421
0,25,3,2,2,0,7,2158216.52157576,6630197.45664282
1,27,4,0,0,5,9,1772256.99962771,7529958.43731253
0,33,3,0,1,7,11,2589239.43496181,4964682.52583248
1,15,1,3,0,7,11,2550126.7813526,6589608.05711138
0,36,0,0,0,5,5,1688554.00567036,5929456.71401529
0,36,5,0,1,4,10,1900281.60364018,3606807.72805144
0,30,3,3,0,4,10,1710233.14752033,4705381.53507226
0,34,6,1,0,3,10,1616286.26182372,5917522.30888885
1,36,5,0,0,5,10,2357327.10390433,4425366.00764386
0,29,1,0,0,6,7,1839271.61425762,4387341.77154175
1,20,5,2,2,4,13,2438838.66713023,4974405.37860431
1,10,1,2,0,2,5,1440142.97217013,5738718.49146274
0,11,1,1,2,5,9,1573832.44422834,6285999.50972926
0,20,4,2,0,5,11,2587715.14593632,8462688.7367163
0,36,4,2,2,7,15,2306611.70846006,7000145.84911731
1,36,6,1,0,0,7,1523871.05491067,4569602.88319214
0,26,1,0,0,1,2,1204537.1831301,4082887.79149579
1,36,3,3,2,6,14,2981014.10597534,7142080.55695686
0,34,5,0,1,5,11,1601198.20884946,4868837.19450669
1,17,4,3,1,6,14,2405747.73115827,3800453.031234
0,20,6,0,0,0,6,1503411.56193608,4886007.93321394
0,29,6,2,0,2,10,1815059.29596172,7068587.2201701
0,10,1,0,0,5,6,1674541.26148522,6900060.88541477
0,33,5,3,0,1,9,2063909.06092327,5911243.92459064
0,14,3,2,0,2,7,2009429.96084391,3632749.22625759
0,11,4,2,2,3,11,1643296.53967977,5590257.18164202
0,18,0,0,1,4,5,1643718.16144588,3993742.61208114
0,32,1,1,2,4,8,1515356.71376014,2494877.39194238
0,11,0,1,2,1,4,1528347.43877894,3737127.86629188
1,35,3,3,2,6,14,2562659.47856373,6854553.11709715
0,21,3,0,0,2,5,1103535.98118811,4917219.79934565
1,39,4,3,2,5,14,2031739.72158075,7976785.27532932
1,24,3,2,1,3,9,2047020.59351248,8926249.32705465
0,36,2,3,2,0,7,1823798.31381911,4846657.94701646
1,28,2,2,1,4,9,1869428.84001567,4662657.39290079
0,21,5,3,2,7,17,2412912.19429127,6374254.75564099
0,25,2,3,0,2,7,1826514.98140932,4364162.30941951
0,19,5,1,2,2,10,1830565.63708995,7024407.76098256
0,36,2,2,0,2,6,1604431.44462226,6005335.57824756
0,19,4,0,2,5,11,2050782.78097702,9924523.50896666
1,10,0,2,1,7,10,2368181.93278199,7326546.70934695
1,10,0,2,1,7,10,2256246.46217142,3192197.12899036
0,38,6,1,1,5,13,2844027.57418027,7129574.10009061
0,20,2,2,2,4,10,1534357.17742761,6069341.77871115
1,21,1,3,2,6,12,2522374.7473169,2698759.7068259
0,12,6,1,0,1,8,1891729.59298354,5149820.50791813
0,24,0,0,2,2,4,1379995.74340069,3705844.51441621
0,25,4,0,0,3,7,1737307.13084538,8469671.8367153
0,19,2,1,2,4,9,1507775.79503407,7738998.43351757
1,12,3,2,0,5,10,1564753.20376614,5353822.5349926
0,24,2,0,1,6,9,1885081.74197434,4937316.10262268
0,22,4,1,0,3,8,1959661.90323811,7725520.65164863
0,10,0,3,0,2,5,1734859.84184099,3665849.0973305
1,27,3,3,2,6,14,1774388.39413538,8179674.00151872
0,27,0,3,2,3,8,1858383.73604722,7385465.71020113
1,35,1,3,1,4,9,1715252.79355378,7041234.6847744
0,36,2,2,0,7,11,1822015.87772554,7617888.72899023
0,20,1,0,2,0,3,1100033.44905011,1885734.32101568
0,18,2,2,1,3,8,1905512.8255365,8138047.51395996
1,40,3,0,1,2,6,1400846.58603518,5550882.18582511
0,12,5,0,2,3,10,2288562.7344593,6076508.18815565
0,13,6,1,0,7,14,1986851.67876338,6927342.22157471
0,16,1,0,2,7,10,1847550.53796712,9172187.71215272
0,16,3,0,2,1,6,1892892.34870146,4218381.68330582
1,15,2,2,0,2,6,1766683.18492913,7839269.60026352
1,33,2,3,2,2,9,2060811.3983701,5839785.47143602
1,18,4,0,2,7,13,2800678.67103031,8356722.96926968
0,28,1,0,1,7,9,1953012.45144409,7623761.67485349
0,10,6,3,2,7,18,3091074.32800828,8663877.45490623
0,32,3,1,0,5,9,1361298.55922688,4181567.59879215
0,23,6,3,2,5,16,2710127.64852089,14264964.460228
0,31,5,1,1,7,14,2306820.68651083,7801965.8013912
0,16,1,3,0,1,5,1331727.28931509,2399240.84921474
1,24,6,1,2,5,14,2383776.08034199,8078361.76901544
1,23,0,2,2,1,5,1719828.00090886,7124103.58883943
0,31,5,3,0,2,10,1946741.27558132,6112335.67697596
0,15,4,1,1,7,13,2405444.83539221,5429679.71064022
1,36,0,3,2,2,7,2064149.59891058,5394318.63436367
0,31,2,1,1,5,9,2244454.69736326,6459687.56218718
0,23,1,2,0,0,3,1238017.23910239,2317791.26176746
0,32,6,0,2,1,9,2291842.26076574,4640068.8385501
1,18,3,3,0,5,11,2097140.46644246,7403631.11145478
1,11,1,1,2,7,11,1678031.89603048,7825869.46639875
1,22,0,0,0,0,0,1443973.62340783,4229442.49324822
0,22,4,2,2,3,11,1485356.09661474,2061355.07123812
0,38,6,0,0,2,8,1878277.18135911,6007171.30313622
0,27,0,1,0,6,7,1900434.32513501,3430621.93078075
0,34,0,1,1,6,8,1555442.78869042,8532525.52022878
0,26,5,0,2,7,14,1770977.84728071,6053625.75857688
1,34,2,0,2,6,10,2614814.75302356,4171723.43432945
1,11,3,2,2,4,11,2092154.15131214,7318616.20539231
0,28,6,3,0,0,9,1623338.18183971,4474357.13967148
1,31,5,2,1,4,12,2667368.40235524,5285554.11199216
1,30,4,0,2,7,13,2191353.9765282,7368575.64393698
1,23,0,2,1,5,8,2310873.38702125,3543164.78367095
1,14,4,1,2,4,11,1777849.7467149,6580520.42288851
0,36,1,0,1,4,6,1746346.64621478,5927942.22699854
0,18,4,0,2,6,12,1827174.48993868,5690606.62794077
0,15,6,0,2,7,15,2229149.72826898,9232800.67071429
0,19,2,2,1,1,6,1156102.91844247,6192417.39277876
1,15,6,0,1,7,14,1986235.05181145,7822514.22847111
1,34,0,1,2,1,4,1353951.39143311,3233289.1140726
1,16,3,2,0,5,10,1846619.0095724,6416073.46062054
0,32,0,0,1,3,4,1121151.17095975,4557984.2176369
0,29,4,2,1,4,11,1942951.67156146,6946431.53448073
1,19,2,2,2,6,12,2123270.89985199,5280272.26275274
0,15,5,0,1,1,7,1752699.88794975,5574418.48041125
1,21,0,1,2,3,6,2055497.80693739,4115840.0379222
0,34,2,0,2,4,8,2016296.59130735,3085799.71665904
0,36,5,0,0,0,5,1422436.11819645,7484818.92179681
0,27,0,1,0,6,7,1129772.15191872,3607172.31890236
0,16,3,1,2,6,12,1779619.29025952,4145951.76920579
0,16,3,3,1,1,8,1608051.88713266,4422927.39206337
0,36,2,2,1,3,8,1732103.95095518,5326900.17359407
0,28,3,3,0,3,9,1801076.93870063,5271768.22148941
0,40,2,3,2,1,8,2092465.6927129,4220523.69190909
1,24,5,3,0,5,13,3143036.67509128,7834401.7053037
1,18,2,1,2,7,12,2120031.99795092,8074053.76277972
1,34,3,0,2,6,11,2195754.88145718,5394601.57368918
0,37,0,2,0,5,7,1733805.675335,2969636.76679548
1,34,4,1,0,6,11,1535773.43570045,4630668.03128245
0,21,6,3,2,3,14,2192937.16781816,4339477.49776184
1,40,6,3,1,2,12,1821711.91222984,6414532.18298849
1,24,2,0,1,2,5,1490907.74170028,3412609.10095448
0,39,3,0,2,1,6,1613005.22247843,5844297.20409563
1,26,2,0,0,3,5,1555815.38568341,5166493.34076991
1,32,3,0,2,3,8,2268931.40705738,7219012.03924004
0,10,3,0,1,3,7,1581180.02982381,9067031.98422938
0,37,6,2,0,0,8,1975235.91873469,5388960.51105542
0,21,4,1,2,7,14,2158945.2261087,4916351.71992553
0,15,5,2,2,4,13,2094405.77138522,9529430.73447679
1,26,1,3,1,2,7,1758434.60278798,5452838.45068821
0,15,4,3,2,7,16,2638485.1789632,5791381.44813998
0,37,5,3,0,1,9,2129891.64505018,3949215.27270513
0,16,1,1,2,4,8,1469812.45853907,1974376.54769087
0,32,4,1,1,3,9,2131111.37134393,4594894.42157345
0,30,4,1,0,4,9,2003182.71377883,5989344.38419669
0,15,0,2,2,1,5,1654216.02031307,4351235.51833313
0,29,4,1,0,6,11,2134514.49666966,6090874.80434591
0,38,6,3,1,3,13,2585362.5462056,6261149.89729371
1,15,2,0,0,5,7,2059451.90843338,2703751.70322277
0,19,2,1,1,1,5,1451445.40544794,5535909.34917724
1,10,1,0,2,2,5,1369256.20331972,6007164.22170108
1,33,5,0,1,7,13,2047698.62443084,6381902.96397117
0,27,2,2,2,7,13,2353745.08300116,6231939.21291996
0,23,2,3,2,0,7,1537536.44326488,3804605.06348043
0,29,2,1,2,3,8,2004758.36020849,5114558.84303274
0,18,0,0,2,0,2,1882124.65761731,3874609.70498497
0,21,5,1,1,3,10,2107180.32701369,4320478.33222788
0,16,2,3,2,1,8,1541161.51046537,3657004.09912019
0,13,2,3,2,7,14,2976977.2806056,6747899.87069334
0,19,6,0,0,0,6,1776613.38759846,6021324.21519437
0,11,5,1,0,4,10,1984451.35601381,4243515.61984481
0,38,4,1,1,1,7,1765592.34441343,6840354.87660642
0,17,3,3,0,3,9,2143289.05243566,5209571.49887846
0,37,3,2,0,5,10,1677122.5866146,8431131.94675161
0,40,1,1,2,5,9,1759946.07678632,6735660.08519408
1,27,1,1,2,2,6,1900838.45700655,3095004.28813747
1,13,5,1,2,2,10,1676325.4358379,1672904.74051978
0,35,4,0,1,1,6,1422115.36862589,4552567.10682373
0,16,3,3,2,7,15,1880161.88965351,5753097.8996897
0,25,5,3,1,7,16,2650228.06008417,8704312.81647654
1,29,0,1,0,0,1,825288.168441279,5147660.00032301
1,19,1,2,1,1,5,1282848.27798971,7864607.17905876
0,25,4,1,2,6,13,2717929.59209664,5575979.99855768
0,33,0,3,1,1,5,1333898.39641448,3292237.98557067
1,22,5,1,0,0,6,1678961.39532494,4344252.86178785
0,25,2,3,1,3,9,2206507.59811634,5988391.41034818
1,34,3,0,0,4,7,1958857.98680652,4296538.27041836
0,38,4,1,1,1,7,1755358.12773554,3963552.30194841
0,13,1,3,2,4,10,2267692.95967286,7603006.5716382
0,20,5,3,0,1,9,1384317.06518768,6218711.32333222
0,40,0,1,0,4,5,1774493.17654994,3264034.03921582
1,13,5,3,0,6,14,2563242.30021365,6132614.92976037
1,11,5,1,1,4,11,2004925.11595708,7094998.37329079
0,19,2,3,1,7,13,2162180.67221713,4617854.40738621
0,22,0,0,1,7,8,1051887.84997559,3463377.07428068
1,35,5,0,0,4,9,1924345.78583477,6396174.45397533
1,33,5,1,2,5,13,2433575.01203438,8138585.98591403
0,29,5,0,2,0,7,1582858.05394878,9517743.6112724
1,11,0,3,2,6,11,2618895.9480541,8855564.07031021
0,22,1,1,1,2,5,1785243.19361373,3811206.25756741
1,26,6,1,2,6,15,2878804.56237131,9200906.89278794
1,24,0,0,1,5,6,1480754.4814514,4987424.91350813
1,12,1,2,2,1,6,1848582.35805835,6254143.08201903
0,33,4,0,0,4,8,1924624.07993632,3993335.87196812
0,32,4,3,2,1,10,1545085.6545382,7459941.84333994
0,35,4,0,0,7,11,2282854.63793722,6195254.62432127
0,21,5,1,1,2,9,1825618.68575188,4876113.06809904
0,25,2,2,1,5,10,2147197.62567384,7449609.51043129
1,14,5,2,2,1,10,1640232.66563943,4705251.58769769
1,16,6,3,0,3,12,2369843.836034,5786378.66647061
0,17,2,3,0,0,5,1270614.54418458,3740151.21628696
0,17,5,2,0,7,14,1760422.4414444,4887145.86260803
1,25,4,1,0,2,7,1910885.38186333,5854059.15748959
1,37,1,1,2,2,6,1854311.97554554,4536721.5019138
0,32,6,1,1,7,15,2604740.38036733,10053511.7707501
0,35,5,1,1,2,9,1613742.38846405,6135059.72567384
1,33,5,0,0,3,8,1476712.56876678,6116537.51203739
1,25,4,1,2,4,11,1650519.24971128,7819364.11299513
1,33,4,3,2,4,13,3119267.03717059,3563144.63635625
1,33,6,1,1,6,14,2377911.24969804,8728018.330029
0,33,4,1,1,2,8,1604098.81981263,4117401.34983837
0,14,0,0,2,6,8,1462993.11828838,6887085.0791366
1,23,2,0,2,1,5,1477448.68245665,6671614.4046377
0,22,2,3,2,4,11,1905735.68749531,3334976.43243077
1,15,1,3,1,4,9,1236289.00860432,4962236.73366942
0,36,4,0,1,3,8,2108674.77910407,6800816.54961917
1,39,1,2,0,1,4,1675811.28796411,5221854.93153438
0,40,3,3,1,1,8,1832847.14737631,6138656.49553318
1,12,4,2,1,1,8,1874453.30946603,4998249.04290412
1,18,4,1,0,3,8,1727624.60037288,6017982.48914751
0,10,0,3,2,5,10,2269359.82413457,7733048.15713766
1,36,2,3,2,0,7,1484354.66692599,5683051.65046913
1,39,0,2,0,0,2,1229655.8943194,3878498.93451407
0,32,6,1,0,5,12,1870797.47937621,4656166.5190404
1,30,0,3,0,5,8,1564233.37036529,5485448.79716154
0,27,1,3,2,4,10,1825162.84276798,8018688.60568441
0,28,2,1,0,0,3,1279949.12905666,5808224.02222265
0,19,4,3,1,4,12,1780844.24746679,8154313.63674242
1,39,0,2,2,7,11,1952215.2883149,5899347.04977662
0,32,5,3,2,2,12,2205649.60559775,10022690.1618953
1,21,5,1,2,7,15,2771644.97911968,8067653.44299533
1,39,2,1,1,4,8,1514552.38602627,5929174.48929049
0,40,5,3,0,0,8,1959957.74208529,5919107.06572159
1,20,6,1,2,1,10,2263267.96185329,3025888.16466918
0,20,6,3,2,6,17,2502062.72000072,9157260.59907486
1,27,1,1,1,7,10,1400257.95034348,5124647.85292268
1,28,5,0,2,0,7,1825351.89706764,8207256.33814064
1,15,2,3,0,1,6,1887858.91760722,6528172.84098336
0,14,4,1,0,0,5,976840.507037475,6290808.41916212
0,28,6,0,2,0,8,1423799.26369327,5754567.39426376
1,33,1,1,2,4,8,1821934.79842136,2205379.29586397
1,31,4,3,0,6,13,2234741.6872595,9487464.06702355
1,24,1,1,1,0,3,1439190.24888212,911173.628256804
1,18,0,1,1,4,6,1902406.54139456,4296070.81572366
1,12,5,0,0,3,8,1748350.20215511,2725379.73499068
1,19,4,1,0,7,12,2138894.17594267,8355065.17594992
0,37,5,1,0,7,13,2384371.56941225,8117216.3781183
1,40,6,1,0,6,13,2298378.7434406,6754296.11275229
0,38,6,2,2,7,17,2689117.55971933,8990663.0268531
1,25,5,2,2,2,11,2074222.12087901,4819416.30676859
1,35,1,1,0,0,2,1584638.56484159,3010932.68477462
1,22,1,2,2,5,10,2083839.71582452,7968411.56681698
0,20,3,2,2,7,14,1682220.26443599,7653766.82398274
1,20,5,2,2,4,13,1755294.56822617,5614367.43840405
1,31,4,1,2,1,8,1439969.51096476,5713678.62244924
0,19,1,3,2,2,8,1609491.22152746,1609491.22152746
1,18,6,0,1,4,11,2425848.66984258,2425848.66984258
0,25,5,3,0,6,14,2556217.13634897,10618697.3546365
0,20,2,1,0,2,5,1259779.87030777,1978964.05480867
0,21,4,0,1,6,11,1782018.09238079,3218017.85432946
0,25,1,1,1,1,4,1743620.6981846,4023781.64076795
0,22,6,1,0,7,14,2141978.80778825,8321177.71995387
0,36,1,0,2,4,7,1289006.38746599,9186554.018719
0,23,2,3,0,2,7,2118279.89334362,5353876.02468435
0,34,3,3,0,6,12,3049403.57786394,9647135.13929908
0,19,4,3,1,6,14,2665380.67430116,6519681.21875304
0,33,3,3,2,5,13,1970714.16467327,8702542.25864021
0,29,4,2,0,7,13,2232637.47268259,6011020.93427069
0,30,2,1,0,5,8,1121575.43540459,10471852.3510611
0,25,5,3,1,4,13,2349746.97990233,7592212.11369072
1,40,2,1,0,3,6,1036053.73432689,5055771.53816178
1,38,3,3,2,3,11,1837466.43098838,3916846.49476053
0,39,3,2,2,6,13,2073791.42123235,7727147.38102286
0,15,3,1,2,7,13,2229931.55343868,4102955.4614628
0,18,0,3,2,5,10,1838482.12631889,6303001.55923487
0,23,6,3,0,4,13,2779439.64738507,9544887.30011174
1,14,6,2,2,6,16,3052847.87145204,6117268.88477235
0,17,1,2,2,2,7,2006027.82550616,6821948.09667177
0,24,5,1,2,1,9,2102511.90998249,4312329.66465341
0,13,6,0,1,1,8,1729311.1676449,6016889.5377632
0,12,1,3,2,1,7,1487107.73811362,5977749.74423002
0,15,6,2,1,5,14,2528130.97107855,8664375.75314692
0,37,0,2,2,0,4,1310699.52771155,3328661.41273605
1,11,0,0,0,7,7,1284879.17903254,4617549.85446866
0,21,0,1,0,5,6,1768061.88429048,6109092.72519249
1,35,1,1,0,0,2,1402627.34454311,6797084.84046412
0,17,0,0,1,6,7,2113416.56193271,5665881.81916776
0,11,2,0,2,2,6,1414052.51822972,2206857.19038341
0,40,1,0,2,7,10,2060145.77176182,8330716.13020672
1,10,5,3,1,5,14,2477505.2034809,8660299.10587298
0,28,4,0,2,4,10,1863312.86762162,5919970.02994797
1,14,5,3,1,0,9,1257942.68868767,5565200.90897754
0,34,1,2,2,6,11,2139836.73100861,7166003.50988751
0,20,0,3,1,3,7,1404685.73802317,7108785.70194441
0,22,2,2,2,7,13,1983626.83708483,6898153.49233331
0,35,3,3,2,0,8,2427906.10498863,5216540.7110039
0,20,5,1,2,2,10,1271515.37028695,6587447.24091398
0,10,2,1,0,1,4,1401242.09620937,1625564.14442534
0,15,4,2,1,1,8,1889974.60687673,6242835.388297
0,33,0,0,0,0,0,908132.991177801,2840399.51984477
0,10,3,1,1,1,6,1772633.96068409,4955478.74525283
0,18,4,2,2,4,12,2648893.47345469,7054272.18916367
0,34,4,1,0,1,6,1849936.58274326,4721755.07159088
0,28,2,2,2,1,7,2129792.21706778,7195375.65286476
0,18,4,2,0,3,9,2301473.56847154,6428078.77395545
0,12,5,1,1,1,8,1836294.23459017,2634770.76221808
1,10,5,0,2,3,10,1510504.31219179,5526000.44055982
1,30,2,2,0,1,5,1712924.77240826,4915714.03511902
0,20,0,3,2,0,5,1585818.80090883,3882264.43129929
0,22,2,0,2,5,9,1808015.96545944,4360361.12746169
0,25,5,1,2,3,11,1953768.54301125,4849841.33365216
0,34,1,1,2,7,11,2133116.33172806,8542417.05938565
0,33,2,0,0,6,8,1880080.61725529,6108218.76507041
1,16,6,3,2,0,11,2209662.1727297,5370425.50894805
0,28,4,3,1,1,9,1899345.9141574,4524813.97027071
0,20,1,3,2,5,11,2312926.55952342,5486158.28970152
1,37,0,3,1,0,4,1416004.49919222,1314808.91567302
0,22,5,1,1,2,9,1773138.92168447,4481081.80277748
0,20,1,0,2,5,8,1800014.35321668,5339344.57430714
0,24,3,0,0,5,8,2203124.5212064,6862353.79926367
1,34,1,0,0,6,7,1288798.56330927,7592948.01639119
0,16,4,3,1,5,13,2103823.67600501,5885797.77699038
1,32,1,1,2,4,8,1429734.47283828,2694872.41665272
0,33,5,3,2,7,17,1946374.48129692,10936687.1715478
0,13,5,1,2,7,15,2283788.12549307,10732313.4286578
0,11,6,1,2,5,14,2833623.32075738,7631788.31834794
0,29,4,0,0,0,4,1241211.61855777,5581567.45012616
1,30,6,3,2,3,14,2265811.63771204,7073887.69768853
1,33,6,1,0,3,10,2077614.52094414,6561022.10133587
0,10,6,1,2,1,10,1986236.71462888,9385252.34178382
0,25,4,2,0,7,13,2020707.71053199,2124017.69060334
0,36,3,0,2,3,8,1913913.20228717,5693981.78925549
0,28,1,2,2,0,5,1956033.51640447,4294621.86343228
0,23,4,2,2,6,14,2281241.27369042,8126940.57810766
1,40,6,1,0,2,9,2001775.14167187,6618452.88060927
1,28,5,3,1,0,9,2295715.80598533,7224937.13024534
1,30,0,0,2,6,8,1862066.35639392,5514434.79091534
0,30,2,2,1,3,8,1987058.16410638,3489483.457887
0,19,4,1,0,2,7,1856829.95609874,5092611.72819802
0,39,3,3,2,4,12,1758143.52071789,6236092.30254618
1,40,2,2,1,6,11,1982430.0570927,6257952.04062113
1,30,3,0,1,5,9,1582400.15277378,3892996.75641859
0,15,4,2,0,6,12,1935641.25736288,7612833.20249717
0,39,6,0,1,6,13,2027943.81414785,3287203.70971484
1,37,0,3,2,4,9,1810250.11082879,3082639.63731581
0,22,6,0,2,6,14,2118248.25559923,5970988.0404134
0,13,0,1,1,5,7,1455680.94494587,3979534.09244272
0,32,3,0,2,3,8,1738590.5961308,5572528.16043153
0,17,3,0,1,2,6,1268131.11815562,2980733.6490219
0,19,1,0,1,6,8,2073852.48198928,4588307.1788679
0,36,5,2,1,1,9,1269704.24714168,6108659.86602977
1,24,2,1,0,0,3,1218748.8943952,5456222.55578726
1,30,2,3,0,6,11,2128138.80761481,4747611.32503118
1,15,4,3,0,1,8,1757120.43128662,5456271.95594073
0,37,4,2,1,4,11,1931524.6893699,5460953.0947585
1,36,6,2,2,3,13,1642720.16945101,5824059.27312076
0,13,1,0,2,0,3,1487745.78978866,3748608.85367833
1,16,0,1,0,1,2,1302064.91969674,2748866.91183764
0,10,0,3,2,1,6,1240006.57272832,4058277.6953688
0,31,3,1,1,0,5,1586894.56350763,1523638.11011988
1,18,2,3,1,6,12,2181679.64073676,7873526.88162309
0,20,1,0,0,6,7,1702859.4926525,5871052.72480843
0,29,0,0,2,4,6,1569166.95151384,3613968.02183425
0,10,3,3,2,0,8,1997128.3726368,5402888.62700626
1,36,0,0,0,1,1,1155591.33240385,4626670.7583229
0,40,4,1,2,4,11,2374567.79562069,4707741.82399024
1,10,4,1,1,6,12,1434131.00937636,6374667.52824269
0,26,6,0,0,5,11,2265938.49233288,7430916.72965341
1,34,0,0,2,6,8,1760830.08135728,6915501.12323768
0,27,4,2,2,1,9,2010518.87622651,6612123.37513137
0,12,5,1,0,6,12,2422944.80232633,11324926.9634948
1,11,6,0,0,4,10,1978173.79458083,4373136.15482937
0,32,4,3,1,2,10,2179884.10439374,2043811.21992651
1,29,0,0,1,4,5,1418449.24664986,5607968.37784983
1,13,4,3,1,1,9,2065718.1196672,2330637.90631729
0,15,5,1,0,4,10,2210455.65029617,4587335.54574924
0,16,5,3,0,3,11,2265662.62204281,7041014.81747896
0,40,4,2,2,5,13,2836276.23382831,5120294.84951669
0,13,0,3,2,6,11,2239410.23853036,4847372.66436556
0,22,6,2,1,5,14,2014381.24355407,5885232.18564707
1,13,2,2,0,6,10,1977076.03303117,4583845.75106187
1,18,1,0,1,6,8,1648658.11379358,4491588.92587408
0,18,3,3,2,1,9,1970005.51443689,2666069.26844996
0,29,5,2,0,3,10,2131665.48824333,5721428.46515641
0,23,0,1,0,2,3,1299871.54120447,5611734.86114197
1,36,1,0,2,6,9,1912491.44267744,6742533.38630217
0,27,3,2,1,7,13,2683049.97032441,10997660.6355258
1,25,2,2,2,6,12,2199021.01307242,7121975.75643665
0,27,0,0,1,5,6,2144995.41799831,4792701.30872503
0,10,5,3,0,4,12,2072210.84678474,8541783.67314253
1,32,1,3,1,7,12,1946400.04466779,6891200.0907281
0,31,2,1,1,2,6,1818173.71500724,3590878.569971
0,21,5,3,2,6,16,2237954.87939731,5701097.73237454
0,33,0,0,1,6,7,1432348.85285115,5396726.73039252
0,25,1,1,2,0,4,1228984.45384981,4277573.60182008
1,19,1,1,0,2,4,1018079.38596309,2399658.06801931
0,38,5,2,2,6,15,2781981.3922083,8544126.07292311
0,14,4,2,2,4,12,2413695.81675371,5763335.18725275
0,22,0,3,1,6,10,1659025.33137146,6812660.28936751
1,11,6,1,1,5,13,2385378.04131747,6998314.65652136
1,33,4,3,0,2,9,2383483.96892757,5911381.36978839
0,21,3,3,1,3,10,2432622.82132652,4914257.63185596
0,36,5,1,2,6,14,2285374.99985362,12543675.2797679
0,33,2,1,2,4,9,1885384.75811684,4582075.47939319
0,16,6,3,1,1,11,1738611.5620745,6426667.05746493
0,26,4,0,2,2,8,1360193.15664116,5003470.66988157
0,30,6,3,2,7,18,2247063.31771997,10668164.426291
0,32,3,2,0,3,8,1719683.87446,6402253.55258655
1,38,3,3,2,1,9,1827140.66632565,4794918.96634105
0,12,4,0,0,2,6,1762812.57520224,6999981.41593548
0,25,1,2,0,1,4,1267036.30525168,4490266.2878579
0,20,1,0,1,4,6,1698287.98444449,6425376.96215161
0,20,3,0,1,5,9,2766034.55333793,3596291.50739041
1,35,2,1,2,6,11,1606084.27418512,7022569.33046478
1,14,6,3,0,1,10,2270183.06074385,7184910.29314994
0,22,6,0,0,0,6,1929092.36969792,5305752.52191583
1,39,2,0,0,6,8,1606541.85688258,4591259.30138971
0,12,5,1,2,7,15,2577473.06291674,4611775.7792304
0,40,5,0,1,5,11,2326600.31907244,6132293.57563364
0,33,1,0,0,1,2,1259307.43440434,2875978.20112216
0,22,5,1,0,4,10,2307812.32633968,2405433.32277753
0,15,6,0,2,3,11,1582049.90757665,8387689.89104855
1,24,1,0,1,0,2,1112415.32014509,805671.302926512
0,37,3,2,1,4,10,1852984.54009474,4891266.47162082
0,22,5,3,2,4,14,1841168.4059901,7664232.01206161
0,27,5,3,1,7,16,3411378.5196308,10187656.6782609
0,13,6,2,0,1,9,1668012.62424699,8113865.0471374
1,14,4,1,2,3,10,1892597.930576,6445649.90653811
1,36,5,2,2,1,10,2125162.70408005,4875098.32197947
0,34,4,2,1,7,14,2156535.74405584,3775852.31844036
0,27,1,0,0,7,8,1858098.57465442,6141462.86315469
1,36,0,2,0,3,5,1543964.14413616,1543964.14413616
1,12,0,0,1,1,2,1242641.24803088,3416741.54164863
0,32,5,1,0,7,13,2765666.8103831,10389234.8323335
0,16,6,3,1,5,15,1825253.74214239,7827303.76144639
1,27,3,0,0,2,5,1181847.27417634,6857096.08508754
0,21,4,3,2,3,12,2386707.53357694,6945634.40625603
0,27,4,3,2,4,13,1776797.68118696,3934067.43661475
0,31,5,2,0,3,10,1819148.81832022,5932633.91388454
0,30,0,1,1,3,5,1575143.94389173,269092.832914031
0,32,6,1,0,7,14,1958385.89760349,6565149.04140047
0,15,2,1,1,1,5,1393887.01925245,4607749.84271875
0,11,5,3,0,6,14,1961691.8959305,10382354.6615462
0,27,3,2,0,1,6,1465016.03595219,1990344.4419224
0,14,6,1,0,5,12,2381312.18018311,9535773.03016106
1,15,6,2,0,0,8,1593719.36384136,5330828.22244418
1,17,5,2,0,2,9,1761194.17357723,3948615.51144621
0,22,5,1,1,6,13,2092372.40737902,9587078.78451653
0,20,0,3,2,2,7,1742778.51548217,5138045.33569593
0,13,1,3,0,6,10,1961982.84782388,5959112.06578213
0,13,3,0,2,1,6,1725800.78449664,4661518.64579054
0,23,1,2,2,6,11,2114619.44187466,7977345.66547955
1,15,4,0,2,6,12,2636751.96412574,5255426.19701009
0,17,5,1,2,5,13,1968605.55951435,7385193.38172874
0,28,3,2,0,0,5,1796994.25430022,5089787.38773996
1,35,5,0,0,6,11,1869108.74814002,7695906.50893916
0,33,0,2,2,2,6,1486411.67091803,5081446.39671625
0,15,2,2,2,5,11,2019719.43080029,6200806.75457545
0,11,3,2,2,4,11,2413223.43726528,4538079.58569263
1,20,4,3,2,0,9,1841148.67662321,3812183.22733394
1,32,6,0,1,4,11,1558602.78282641,8043781.8089234
1,10,3,1,1,3,8,2182318.03750047,3671210.96505213
0,13,5,0,2,7,14,1929601.93245059,5190523.42666963
0,38,5,2,1,7,15,2762723.08790019,6828356.227486
1,38,2,2,2,0,6,1554521.77217361,1554521.77217361
0,11,0,3,1,4,8,1767611.33657904,4331272.51606608
1,26,5,0,2,5,12,1331445.61038667,7496588.4629707
1,31,0,3,1,0,4,1340996.51021989,4734951.74155725
0,23,5,1,1,4,11,2258968.79365951,4814520.98703234
0,17,5,2,1,0,8,1712407.58396632,2370005.96985939
0,13,2,2,2,5,11,1864107.21091602,4538737.63817167
0,12,3,3,0,7,13,2466636.81923669,8915145.36085655
0,18,5,3,1,7,16,3009532.25281203,11101773.9844457
0,31,4,1,2,2,9,1770053.52093554,7430420.31015142
0,29,0,0,1,0,1,904526.111052135,1360164.05144051
0,40,0,0,1,3,4,1693203.38559838,6451340.81168272
1,30,5,1,0,4,10,1869347.48316849,5493160.70302677
1,34,3,2,1,0,6,1991033.21233506,4080117.52259266
1,13,5,0,1,3,9,1238348.86606512,4355723.68000907
0,23,2,2,1,7,12,2409298.8819649,7397989.85693589
1,18,5,1,1,7,14,2682959.06855172,11587662.5297107
1,36,0,2,0,0,2,1227307.0455068,946329.432813327
0,39,3,2,0,4,9,2130645.1052216,6893101.78996504
1,32,3,3,1,3,10,1674751.20862942,2856380.42815784
0,30,6,1,1,2,10,1486927.2558068,5712639.69781102
0,12,3,0,2,2,7,1156577.40104951,6451536.35112021
0,15,3,0,0,0,3,1014392.39491193,3821400.28569923
0,21,3,3,1,5,12,2110505.38036972,3560184.1949209
0,21,0,2,2,3,7,1795980.59661458,4924381.37886999
0,11,4,1,2,3,10,1610369.77539045,3523271.9749745
0,34,0,1,0,5,6,1496618.49538522,3393675.22024416
0,27,2,0,0,0,2,1249547.17832551,5098817.07801131
0,31,2,0,0,5,7,1789893.76612231,7611568.39327354
1,25,3,0,1,3,7,1631942.62092038,4933413.14243502
0,36,6,0,2,2,10,2068051.45087162,7107284.88306856
0,20,1,3,2,3,9,1504485.19995872,6636495.63032972
0,38,6,0,1,2,9,1946380.06596618,3634864.89310076
0,33,5,0,1,7,13,2698390.04878557,4297945.16193131
0,25,0,1,0,7,8,1169517.35065546,4544940.23849467
0,18,1,3,2,0,6,1504669.7016354,2840928.15247271
0,35,3,0,0,3,6,1565308.83225753,5097566.76514168
0,31,2,1,2,4,9,1619499.21650725,3124624.33562443
0,25,3,3,2,1,9,1478311.06459024,4532885.89871191
0,30,1,3,0,1,5,1457729.64194628,3540767.00847534
0,23,4,1,0,1,6,1399829.07051691,4879874.46319168
1,18,3,2,0,0,5,1403525.73735546,5117944.17907776
0,15,3,0,1,1,5,1429100.95674685,3370640.46159295
0,34,2,0,0,3,5,1106870.78428038,7174980.09665182
0,38,6,0,0,2,8,1871364.89795852,6995159.07828882
0,26,1,1,0,3,5,1108501.97333247,5887468.83121274
1,12,6,2,0,3,11,2134407.78041867,4760417.63515527
0,36,5,3,0,0,8,1554244.25957253,8918691.69765345
0,23,0,0,2,4,6,1682399.1995838,4654168.1954957
0,23,6,0,0,2,8,1907598.39850103,5187726.37592723
1,13,0,0,2,7,9,1650880.78102682,6693847.70086371
0,29,4,0,1,1,6,1544137.9685364,3658356.44108937
0,23,2,2,1,7,12,1865201.61278481,9198153.23447545
0,27,4,3,1,2,10,1983375.26721376,3992286.49068623
0,37,2,1,0,2,5,1543737.66811874,2425243.84948511
1,39,3,0,2,6,11,2310954.46323626,6925456.80636765
0,33,6,1,2,1,10,1924800.45982565,8013268.12628017
1,10,0,0,0,6,6,1581318.91051479,5234994.06653811
0,17,6,2,1,1,10,1690385.0369873,7046147.42236395
1,22,3,0,0,1,4,1184004.82596679,4943005.7997797
1,24,0,3,0,0,3,949725.689449402,4313021.41665645
0,34,6,2,0,6,14,2356765.14658756,7442124.36688431
0,25,3,2,1,6,12,2522460.02281186,6145335.7728476
1,10,2,2,2,2,8,1350717.41687604,6518217.46790952
0,16,3,2,0,3,8,1995507.67901707,5099219.5497312
0,17,1,0,1,5,7,1356485.30445164,4985182.1928018
0,28,4,1,1,2,8,2009479.57914206,4385944.97754255
1,23,6,3,2,7,18,3408180.47026088,7963405.97878249
0,20,0,1,0,2,3,1666603.26558788,2933871.3127168
0,25,5,2,1,0,8,1741243.8713616,4620567.10915757
0,13,0,1,2,4,7,1740946.0628963,5125119.79749186
0,20,0,1,2,0,3,1299008.58838737,6717837.64937973
0,21,1,2,0,3,6,1887790.50359488,4824518.06077107
1,34,2,3,1,5,11,1678994.51665959,4156957.49406428
0,24,1,0,1,6,8,1864506.7677905,1285415.85879658
1,24,0,3,2,7,12,2178417.15003027,4787804.78203484
0,14,0,2,1,3,6,1667382.51537297,6128364.21709798
1,14,6,3,2,3,14,2624742.20002421,4671883.54341903
1,13,3,3,2,4,12,2114054.71219129,5425228.03372297
0,18,5,2,1,7,15,3246855.96935679,7182672.24912227
1,24,0,0,2,2,4,1564300.13222856,5266837.93457984
0,22,4,0,1,5,10,2035490.80427609,8754888.83088898
0,11,2,1,0,0,3,1406702.85611826,3599536.45993497
0,28,1,2,0,6,9,1658326.07338698,4934465.10946137
0,24,2,1,2,0,5,1133985.99974098,5886597.8245967
0,39,5,2,2,6,15,3312066.18028207,7459663.13119778
0,39,5,0,2,3,10,2068334.23976574,4806307.81710555
0,26,0,2,1,4,7,1364236.65740345,2879524.96147364
0,32,0,1,1,5,7,1202769.05809953,4183204.58847489
0,16,1,2,1,1,5,1195604.9624539,5756073.25815408
1,12,1,3,2,5,11,1922963.37417703,6789027.52887965
1,19,4,1,0,3,8,1871640.34294898,7071353.58389742
0,28,2,2,0,0,4,1413358.49678704,5205049.29327672
0,21,2,0,2,7,11,1902525.64995626,7502894.66164745
0,26,3,0,0,3,6,1665774.18701396,7822664.41713531
0,14,6,3,0,3,12,2215073.36144636,5556901.43223179
0,38,0,3,2,6,11,1586343.97293098,5240525.60246145
0,23,4,3,2,5,14,2320999.83377677,6299547.59930287
1,24,0,2,0,1,3,899187.663437906,4078304.99862018
1,31,6,1,2,4,13,1995331.06069092,6386705.97270736
0,14,5,0,1,4,10,1960641.42640022,5734840.13614672
1,16,3,1,2,1,7,1571590.41063861,3572915.87253036
0,11,2,2,2,3,9,1923252.49928602,9367830.93491989
0,19,5,2,2,7,16,3231084.94437088,9141349.81928666
0,24,4,1,2,3,10,2135751.03737057,3116185.31536068
0,37,4,3,2,0,9,1929566.99519037,6489496.39941432
0,30,0,1,0,7,8,1445508.05535491,5963056.86635868
1,28,5,0,2,5,12,2580468.75709623,6743896.56174457
0,12,6,3,0,3,12,1849401.08111954,5225655.65198178
0,37,4,1,0,6,11,2187608.71225197,7789235.03610888
0,33,0,1,2,3,6,1748515.08818111,4395389.92599346
0,22,3,2,2,3,10,2177754.21147178,7090691.38810356
0,34,1,1,2,0,4,1422207.75109692,4160884.23046434
1,25,5,1,1,3,10,1884561.75313229,7100222.65268684
0,29,1,2,1,1,5,1152138.46334697,1459103.64363826
1,16,1,1,1,1,4,1630832.39313388,2629045.91341972
1,40,6,2,1,7,16,2204143.6924672,9030972.97658479
0,25,2,3,2,0,7,1622637.87510971,4700919.58248301
1,17,4,2,0,4,10,1551989.78991706,8234996.08181972
0,29,5,2,1,0,8,1720399.26079955,6392471.44237025
1,24,6,1,0,6,13,2381789.79395729,8679880.70568818
0,23,5,0,2,3,10,2174021.96862316,3068834.7730725
0,40,5,0,1,6,12,1891726.45169455,8122875.49227848
0,23,6,2,1,6,15,1723296.23328163,3474611.54844209
0,32,1,3,1,3,8,1889138.2607711,4414342.51939439
0,16,2,2,1,1,6,1532737.09284474,5516448.37868793
0,17,3,3,0,6,12,2314408.9282478,6497862.49082855
1,31,4,2,2,7,15,3016931.1457609,7895194.38989883
1,12,2,2,2,5,11,1627659.78027365,6872959.16530933
0,25,0,1,1,5,7,1872627.96356909,5491279.1978359
0,23,6,1,2,0,9,1857112.05211075,7522434.1902299
0,23,5,3,1,5,14,2202110.54146399,8483474.43587143
0,24,5,0,2,6,13,1878148.29943122,4884643.13890431
1,27,3,1,1,0,5,1458425.59135013,5675400.76923836
0,26,0,0,1,2,3,1241153.26186866,3795183.62037543
0,30,5,1,2,6,14,2143755.01714119,7892152.0450569
1,17,0,0,1,3,4,1798731.32599178,3809122.68984215
1,20,3,0,1,1,5,855639.142410063,6847758.55788891
0,29,4,2,1,2,9,1707986.88035309,5270701.27043747
0,34,1,0,2,4,7,1511671.06583214,6500780.92873864
0,29,1,3,0,2,6,1392185.44837881,7485979.37891108
0,17,5,3,2,7,17,3688410.98329768,6620034.22127482
0,24,0,3,0,2,5,1536047.43745716,6277969.90458136
0,13,2,1,1,4,8,1472898.65012491,4548102.96925035
0,17,6,2,1,7,16,2283492.03610518,5544970.12599493
0,25,5,1,1,2,9,1681947.40552185,5422935.3682473
1,17,2,0,2,2,6,1628429.83775776,7006338.97622249
0,40,1,1,0,1,3,1379662.12253987,49240.5392879511
1,40,3,2,0,2,7,1721399.31009496,6257894.61591909
0,39,0,3,0,6,9,2188519.54880305,7353870.10514519
0,33,2,0,1,1,4,1309099.953976,3517653.04892819
0,39,2,0,1,7,10,1924638.03214513,4733162.02856214
1,13,5,3,2,1,11,2213672.69921022,5771320.54272845
0,25,1,0,0,5,6,1671903.88116155,4772147.12845515
0,13,1,1,0,5,7,1820037.54550093,6826860.11033134
1,38,5,3,1,1,10,2072293.97506654,3198115.4596646
1,17,1,0,0,5,6,1701086.58127079,6406451.468436
1,36,5,1,1,2,9,1859158.6400384,6132411.88708349
0,39,2,0,1,5,8,1768724.3864708,3962653.62626498
0,37,1,1,0,2,4,1341782.04163417,2953227.55835916
0,35,5,3,2,6,16,1906746.28455344,6915613.28468554
0,38,1,1,1,3,6,1648903.08849147,2719953.71188684
0,34,3,0,0,5,8,1631189.14870338,5791565.73057754
1,40,1,3,0,3,7,1703557.43702993,4422322.8818872
0,16,6,2,0,1,9,1666401.81277308,4844322.1220439
0,27,5,0,2,3,10,1788255.17479448,4112250.46013222
0,25,3,1,1,2,7,1876699.02413679,5767942.25745213
0,28,6,1,2,3,12,2431582.60011446,6825911.09341957
1,39,6,0,2,3,11,2215752.04312501,4169887.09006961
0,38,0,2,0,1,3,1643346.47284378,5385986.94687792
1,12,5,3,0,7,15,2480514.83897642,10929055.2371436
1,29,4,2,2,7,15,2276650.13862167,5156232.72737964
1,10,5,1,0,2,8,1872065.36941465,7480891.30177192
0,30,3,2,0,0,5,1390400.57756893,4174528.14254194
0,13,0,1,1,2,4,1184001.05203713,1968185.91240133
0,19,3,3,0,5,11,2482426.97926014,7394932.16732492
1,23,6,2,0,5,13,2117353.2832049,7654826.04779438
1,10,3,3,1,7,14,2006025.76161401,8622960.47819544
0,16,1,3,0,0,4,1199353.22221348,5403155.67156005
0,33,5,3,1,6,15,1388860.00887792,7156371.183001
1,29,4,1,2,5,12,2308178.74472066,8444299.68232885
0,19,5,3,1,6,15,2347552.67444284,9914871.86501347
0,15,6,1,1,5,13,1813011.49383604,7145616.73046575
0,19,1,3,1,4,9,1932981.73646413,7999607.00510384
0,33,4,2,2,7,15,3228962.53888207,5875584.97351202
0,31,3,1,0,1,5,1443820.16396033,4739963.93095035
0,32,4,2,2,2,10,2426473.05009777,4559003.9283038
1,17,3,2,0,0,5,1829373.64264811,6852019.65695625
1,13,6,2,1,6,15,3023117.33107761,10567648.2212407
0,31,3,1,1,6,11,1901842.17480173,8790437.59918973
1,40,6,3,1,2,12,2214496.11179924,544251.769642603
1,25,6,2,0,2,10,2054455.85621372,6910648.7496549
0,16,2,1,2,3,8,1832270.53111733,4189398.26118835
0,18,4,2,1,5,12,1276253.45341345,6595205.91747968
1,28,0,2,0,4,6,1519213.28512069,2290141.48688305
1,39,6,2,1,0,9,2351516.74981522,4815291.02554675
0,12,1,3,1,6,11,1957040.80624513,5903011.10649119
0,37,3,2,0,1,6,1699838.85476279,4263350.59653999
0,14,2,2,2,1,7,1929774.37170025,4093070.82853216
1,25,0,0,1,6,7,1752553.26620908,5853948.90102591
0,31,0,3,1,4,8,1056321.93169124,5983283.61752114
0,38,1,0,1,7,9,2139657.28650929,5671052.9189205
0,11,1,3,2,1,7,1666892.96515632,3441863.36452978
0,38,1,3,1,6,11,1708919.60584145,10627283.668417
0,27,6,3,0,3,12,2786624.70094843,8904900.24010081
1,27,4,1,2,5,12,2493557.70178978,3680333.00768374
0,25,0,3,2,0,5,1823395.86766612,5116129.69381719
0,17,3,3,0,0,6,1521038.17541545,2019251.73104581
1,30,1,0,2,5,8,1951442.28580057,6767029.03074043
1,10,5,0,2,3,10,1870064.21869783,4468012.73668307
1,31,3,3,0,4,10,2406384.83304098,8686678.71750096
0,15,3,2,1,2,8,1506469.68622957,6176693.41166749
0,25,5,1,1,7,14,2684197.79466044,5751515.74340809
0,36,5,0,0,0,5,1124642.18939274,6176433.52465222
0,17,5,3,2,5,15,2365208.27507667,3263967.39108701
0,17,2,0,2,1,5,1496598.45632328,4528747.17104033
0,19,3,3,2,2,10,1747020.92052078,7585065.10039739
1,37,6,1,1,4,12,2284387.92835192,6429172.57267644
0,25,1,2,0,4,7,1378206.88204108,6953851.70534005
0,14,3,1,1,6,11,1880219.37863621,7060016.61447262
0,25,0,2,2,2,6,1695948.28792284,4627858.45745352
0,35,2,0,2,3,7,1206789.91634703,8191849.08694935
0,35,6,2,1,5,14,2988999.20826148,6336873.98657089
0,31,6,1,0,2,9,1649098.95966774,5760085.35852263
0,36,3,2,1,3,9,1267940.93111535,5724807.75293008
0,26,2,2,2,3,9,1424548.35447513,5107088.93608537
0,24,2,1,1,5,9,1731113.79839832,4974157.55638835
0,36,4,2,1,3,10,2491187.68785795,6812130.98449086
0,19,5,3,1,2,11,2023854.2655031,7711407.36851112
1,15,1,2,0,2,5,860084.624855918,4420513.73791152
1,22,2,0,0,5,7,1615275.09566831,3151032.33511521
0,26,2,0,2,5,9,1813006.463182,4219440.88400176
0,20,1,2,0,0,3,1553852.87209872,3913402.85249145
1,25,2,0,0,6,8,1750737.70013945,4234945.6222875
0,25,0,0,2,6,8,1801478.58876356,5991131.31285357
0,30,5,0,1,0,6,1477576.0623466,4775998.74254868
0,30,2,2,1,2,7,1838725.77061466,4276416.84763901
1,15,6,2,1,5,14,2536911.19600494,9595608.09099976
0,29,4,2,2,6,14,2527223.08932935,7923950.86784024
0,21,2,2,1,1,6,1521216.62041847,2619773.79519505
1,31,2,2,2,6,12,2040312.97846323,2499067.71844331
0,28,3,2,1,5,11,2051403.24326221,8805439.24877279
0,30,0,0,1,4,5,1352609.42107006,4240379.68499039
0,35,2,3,2,2,9,1882039.67594399,4017526.31873893
0,13,2,3,0,2,7,2140992.93021305,2940297.42760386
1,30,5,0,1,2,8,1976910.47083604,3564877.96349854
0,37,4,1,1,7,13,2183767.62632733,8808262.44070515
0,14,0,1,2,1,4,1570956.22370014,2469996.53351769
0,36,2,2,0,1,5,1515533.9453518,6619105.49378339
0,27,0,2,1,3,6,1365387.93519714,5947949.6845946
0,30,5,3,0,7,15,2032092.19284844,6283077.65463213
0,19,4,0,0,7,11,1754996.08111392,6992269.41986517
1,33,0,2,0,4,6,1527649.01409861,6944804.99415503
0,32,4,1,2,3,10,1707050.96478535,6857296.71451846
0,16,1,1,2,2,6,1539052.29691975,3941109.52931574
0,29,5,2,2,1,10,2214270.21987355,8878460.05516744
1,14,3,1,2,6,12,2310758.23485167,6905959.65771744
1,21,4,2,0,3,9,1825281.36667273,4467090.36722129
0,39,2,1,0,1,4,1234988.69987198,3651617.95517357
1,40,5,2,2,2,11,2298118.62737331,8768667.27451593
1,40,6,1,1,3,11,2370077.38725432,5029694.02952206
0,28,1,2,2,2,7,1515120.76470401,4977224.02039555
0,33,1,1,2,5,9,1680058.42907207,7076264.87432432
0,38,0,3,1,0,4,1080858.24219192,1295197.05491819
1,21,2,1,2,2,7,1977715.48997446,4783756.34796953
0,31,6,1,2,3,12,1844173.22901155,11687023.089644
1,30,3,2,1,1,7,1738305.2552541,1610012.36636141
0,37,3,2,1,3,9,1715808.01959581,6642726.79803013
0,40,6,2,0,4,12,1851095.49608102,4174103.70813995
1,17,3,2,1,2,8,2086806.55423929,3937011.29446674
0,39,2,1,1,3,7,1569620.70632249,5083194.15976049
0,20,2,0,2,6,10,1959093.15719255,3006229.76098779
0,20,6,3,1,7,17,2230757.78188716,5009457.24540326
0,13,1,0,0,5,6,1808636.80554296,4712824.56689157
0,23,4,1,0,6,11,2199950.82091382,5578550.28468257
1,39,2,3,0,7,12,2606503.42672969,5372506.19318411
0,10,1,0,0,2,3,1028296.73087318,1319092.83023517
0,10,0,2,1,2,5,1525524.58144338,4679781.98244691
0,12,4,0,0,1,5,1629265.59358862,5309698.14350566
0,33,1,2,2,5,10,1444104.52364018,6832112.93770269
0,15,1,2,1,4,8,1508276.35925562,7369808.60698861
1,27,3,1,0,4,8,2058622.79043202,5766618.908954
0,29,3,3,2,4,12,1685444.09399007,6452649.4250687
0,39,4,2,1,3,10,2070128.30490856,4471565.82844474
1,10,6,3,0,2,11,2193453.43505159,7356368.01476376
0,26,3,2,1,1,7,1923415.50365797,4668156.2503488
1,16,5,2,0,5,12,2441808.69728966,6909603.40105758
0,12,3,1,1,1,6,1525735.24037075,4588796.99563554
0,28,6,0,1,7,14,3108390.42770471,7449545.27095762
0,40,1,3,1,7,12,1609884.26436996,3304563.10694108
1,18,3,1,1,6,11,2118622.1801176,9627993.5719614
0,39,6,0,2,4,12,2424580.90019677,9921653.73967883
0,34,2,3,2,6,13,2365487.23017229,5707905.19048096
0,29,1,3,0,7,11,2364598.38980301,6341466.7217534
1,11,1,3,2,1,7,1479491.30806256,4799393.33227634
0,12,3,1,1,4,9,1683757.73134681,6957017.77425526
0,15,0,0,2,3,5,1341947.71678648,3229777.75445359
0,10,6,0,2,1,9,1588676.39326173,8081413.01459733
0,31,5,0,2,0,7,1626291.60382706,6633628.21407256
1,35,1,3,1,7,12,2091023.78148496,5751618.18497442
0,22,3,3,0,6,12,1610367.2114188,2856709.98519331
0,17,6,0,1,2,9,2469725.90353648,8164323.28327846
0,16,6,2,1,7,16,2807025.1756638,9373838.84595364
1,27,0,1,0,3,4,1349801.50017139,7501701.95843675
1,35,2,3,2,2,9,1535970.8341755,6173630.29120805
1,16,5,1,0,6,12,1860314.98135134,7124484.90368551
0,16,3,3,0,3,9,2234300.96148813,6431844.3036567
0,33,4,2,1,6,13,2738078.85444116,5519936.40662818
0,26,3,3,1,6,13,2662401.1709424,9691177.07393839
1,24,5,0,1,1,7,2015474.76186131,8957662.9362694
1,36,1,2,0,4,7,1820082.58669469,2960871.10691674
1,31,6,3,1,2,12,2270826.85643403,7419499.58710945
0,33,0,3,1,6,10,1879400.10971233,5346595.92268264
0,39,4,0,1,0,5,1496117.06277389,4235610.99786903
1,26,4,2,1,7,14,2203232.17898055,3192831.22644204
1,17,3,2,1,2,8,1985118.26792743,4754890.29198679
0,35,3,1,0,3,7,1895654.87939153,3704514.78986384
0,40,5,1,2,2,10,2522569.44968941,10434356.8378644
1,11,3,1,0,3,7,1487301.54883031,5538599.77506151
0,20,5,1,1,2,9,2009212.91257902,5620293.27391549
1,27,4,0,1,1,6,1869336.59218059,6038041.87345218
1,23,1,2,0,7,10,2167631.40342406,2298466.12525238
0,37,3,1,2,6,12,2714457.05401572,5236347.02580944
0,12,2,2,2,5,11,2000570.87442159,10152340.9821289
0,26,6,2,0,4,12,1578311.14794373,7257914.22882117
0,35,4,3,0,0,7,1575081.58081223,4524452.07671668
0,13,1,0,2,2,5,1581857.05548319,4581916.3040891
0,35,5,0,1,1,7,1523502.18037124,6238512.89848839
0,37,1,0,1,1,3,1294998.37281782,3375570.93703973
0,22,3,2,2,4,11,1806078.80499099,4386994.54084727
1,32,6,3,2,5,16,2147363.73096426,10232607.1104405
1,35,5,0,0,5,10,1924972.21804913,5738630.35815617
1,14,6,1,0,4,11,1961154.52428739,6232657.44534431
0,38,3,3,1,0,7,1932561.40178616,9746604.68385966
0,15,3,2,2,2,9,1808230.89990237,7091343.22510859
0,19,0,3,1,3,7,1562634.16121147,2018795.67814751
0,39,5,0,1,3,9,1181397.74971734,6236071.29984335
1,26,4,3,2,2,11,1922475.50963007,2834046.68979613
1,26,5,1,1,1,8,2017075.43444493,4768337.11390782
0,11,1,0,2,0,3,1361642.76228101,4933884.08002597
0,21,4,0,1,0,5,1551743.37051821,5071318.93632625
0,16,0,3,2,5,10,2057857.95843028,5153136.78234146
1,26,6,3,1,1,11,1751893.49267666,4661761.91879515
0,24,2,1,1,3,7,1853936.1624262,8382874.41532545
1,36,5,1,0,5,11,1941585.89857838,6588443.2096334
1,31,6,2,0,2,10,1718930.7714722,6407035.52600529
0,33,0,0,1,7,8,1978728.01567236,1780139.73175964
0,35,4,2,1,7,14,2063004.80557476,9322637.04874022
0,14,4,3,2,2,11,1765608.36840948,9668988.14584555
0,31,1,2,0,6,9,1997102.61647945,6762462.5024413
0,17,3,0,2,2,7,1893773.61983263,7185550.58125285
1,15,5,2,1,0,8,1536854.90950024,5999410.32230911
0,32,0,2,2,4,8,1782212.2216064,4227795.94193855
0,32,1,1,0,5,7,1870559.33789265,5582558.41263489
0,16,1,1,1,1,4,1005521.28896557,4264057.5160876
0,15,5,1,0,2,8,2257124.45084372,2437565.33559866
1,19,5,0,1,5,11,2342238.18989378,7221993.82689385
0,21,2,3,1,7,13,1782053.52542142,5874803.77515781
0,28,0,0,2,4,6,1436104.3298574,6239599.52567467
1,15,1,3,2,6,12,1999101.11010239,6915252.64744089
0,10,6,1,0,7,14,2606989.40672267,8083517.62754071
0,21,5,0,2,5,12,1847064.84893647,8835434.80398842
1,40,3,3,2,0,8,1540388.63316679,2163074.68320522
0,27,1,2,0,3,6,1781007.65152955,5568968.86098446
1,33,5,2,0,2,9,1845387.43401306,4489331.19022177
0,21,3,2,2,4,11,2338938.03902276,6494645.91779426
0,33,4,3,0,2,9,1663600.65659634,6082820.95096645
0,16,5,3,1,0,9,2090434.26648306,8405760.15470305
1,23,0,1,2,2,5,1832806.76098899,4028129.42552591
0,16,6,2,1,5,14,1654964.3745786,8464290.73964955
0,29,4,3,2,4,13,2366850.48116453,5823812.81050668
0,37,1,2,2,4,9,1904511.01678711,5922751.5707235
0,22,3,0,1,2,6,1573897.65179474,4914681.83946647
0,19,0,2,1,7,10,2186611.12836714,4941765.96718587
0,30,3,1,0,3,7,1859189.69180242,5229119.01679107
0,21,1,2,1,1,5,1851874.5824929,5037643.78680946
0,31,3,3,2,7,15,2997876.34897256,5531623.07446809
0,15,6,2,1,4,13,2956354.23818589,5679106.0977041
0,12,2,2,1,0,5,1704169.60066127,3410117.90751741
0,16,1,0,2,5,8,1573849.71151262,4378135.73116528
0,35,3,3,1,3,10,1598632.94025141,5775575.12387319
0,21,5,2,1,5,13,2141003.96874173,11757166.5012939
0,37,6,3,2,1,12,2228088.4970415,5863349.99410075
0,29,1,3,1,6,11,1908092.22515023,6968387.54950663
0,22,1,3,0,7,11,2130870.45267879,3380048.71702537
1,29,0,3,1,2,6,2005404.9529644,5044850.70721604
0,36,1,0,1,5,7,1663791.72439971,2739529.16083214
0,24,0,1,0,0,1,1181065.4715526,1546180.15823538
0,32,4,0,0,1,5,1391522.02242742,6420648.43402993
1,27,4,1,0,2,7,1050414.0797874,4947637.57194067
0,32,1,0,0,2,3,1230728.87112666,4029487.68778252
0,34,0,3,1,2,6,1676947.91603509,4522336.80431815
0,28,2,3,0,7,12,1500781.08815602,8047106.80013073
0,24,3,2,2,1,8,1892546.25229562,6628130.94333992
1,22,1,1,1,1,4,1240490.38404105,2259650.94533677
1,17,3,0,1,3,7,1670378.02401203,4613660.05489806
0,17,3,2,1,4,10,1924520.27471188,8242512.10097108
1,17,4,0,2,6,12,2765691.97383597,2765691.97383597
0,39,3,0,1,3,7,2097038.10045265,3434567.91442295
0,23,4,1,2,4,11,1863921.60797373,5131382.85881936
1,25,1,1,0,5,7,1527509.12646709,1781020.94881648
0,35,6,2,2,6,16,2672394.95848669,7672606.9455821
0,30,5,0,0,3,8,1616708.1629099,4292105.46836304
0,27,5,2,1,5,13,2098214.13603182,9969423.04987763
1,12,5,2,0,1,8,1939748.78096398,5878896.51516935
0,13,1,2,1,6,10,1896472.54555728,3448852.276602
0,27,0,3,1,2,6,1421205.7119785,1379718.46103137
0,34,3,3,2,2,10,1835919.42567734,6921954.78702685
1,26,4,0,2,0,6,1687441.47277249,3064827.86399435
0,25,3,2,2,0,7,1406600.41990434,6835488.05558936
0,39,1,3,2,6,12,2864087.12553451,8390842.24399831
0,39,4,3,2,7,16,2709572.3367628,8901920.09851898
0,21,6,2,0,3,11,1596229.1321907,7776661.06276285
0,21,1,1,2,1,5,1736124.92407347,5286681.50460769
0,18,1,1,0,4,6,1588571.60978631,5993417.90079985
0,39,1,2,1,2,6,1615883.66336876,5064322.55077767
0,18,5,3,0,4,12,1414053.50872775,8133682.95961647
0,16,0,2,0,2,4,1592157.33000749,2733578.61714919
0,40,3,0,1,4,8,1405199.01433718,5307099.86984355
0,26,2,0,0,5,7,1654372.98078537,5835170.6428335
0,31,1,1,1,2,5,1533907.08778431,3204988.78653096
0,18,0,1,0,4,5,1663885.71671627,6842003.79259156
0,21,0,1,1,3,5,1787660.33673468,8042098.6468014
1,28,5,0,0,1,6,1837438.97831132,3588275.56472066
0,34,5,3,0,2,10,1934700.44271741,9459506.00959191
0,37,2,2,1,0,5,1668089.97944442,6272126.41227372
0,21,6,2,1,3,12,2477029.38552824,7490044.76289263
0,20,6,0,2,7,15,2949434.10480306,9348077.26096229
0,29,2,0,1,1,4,1365385.42389323,7511167.98156408
1,39,2,3,2,5,12,2088298.63134669,6374197.50366007
1,28,2,3,0,3,8,1797137.49957254,4342952.42588227
1,28,6,3,2,7,18,3613318.14034621,6953667.14292887
0,12,1,2,2,1,6,1340426.2336722,4045712.34102139
1,36,6,1,1,6,14,2695676.64129567,6482053.68792954
0,36,3,0,2,5,10,1859532.07690236,5843327.88526608
1,12,0,3,1,5,9,1489559.54316797,8100165.28520916
0,40,0,1,2,3,6,1390015.95020933,5524624.01414002
0,18,2,3,1,7,13,1938819.75265733,7385463.28478195
0,31,6,1,2,7,16,2323052.36730547,9959298.81493973
0,32,0,1,1,1,3,1460207.81523777,6059877.63867168
0,21,6,1,2,1,10,1889704.82063318,9515660.79531008
0,32,4,3,2,0,9,2106756.06685167,4062565.99322149
0,38,4,2,0,4,10,1820192.64591307,4377539.52119938
0,37,3,1,2,6,12,2184701.83543845,7444418.45206748
0,38,1,0,0,2,3,981880.962168727,4825029.18595846
1,37,4,3,2,5,14,2237812.72184622,6094222.06138246
0,15,0,3,2,2,7,1649922.61087975,6320806.00568637
0,37,5,0,0,2,7,1078881.87088275,7500601.69526079
0,35,3,1,0,3,7,1637057.15558395,3291263.0208003
0,23,2,3,0,6,11,2214208.62601819,6746415.78843603
1,10,2,1,0,2,5,1431297.70027054,6595391.02023329
0,11,5,2,0,1,8,1575830.02321473,3463230.55364352
0,19,4,2,2,3,11,2254791.79110717,8559586.5105734
0,15,0,1,1,5,7,1670897.41092786,3793047.55999719
0,22,4,2,2,2,10,1876719.33613026,7069286.5323044
1,29,4,2,0,2,8,1946329.61126608,4194225.98978059
1,37,0,2,1,3,6,1377172.20391763,5655105.13309039
1,16,3,1,0,6,10,2334681.26810795,7183601.274072
0,35,5,0,2,5,12,1873671.06499395,9029935.59831065
1,27,4,3,1,2,10,1998196.05117637,6757687.60114659
0,14,1,0,0,7,8,2137488.45265636,5832971.30098804
0,24,4,1,2,0,7,1436765.92905137,5969459.18811265
0,23,1,3,0,4,8,1818549.70648424,6848969.60499701
0,15,6,1,0,6,13,2562383.03436905,8537972.79262725
1,12,3,0,1,5,9,1812685.90208363,7160405.41408676
0,30,3,0,1,0,4,1646826.00938911,8058253.90210957
0,15,5,2,0,1,8,1765160.08802003,8484457.97654749
1,24,6,1,2,2,11,2814899.89768482,9455444.24916493
0,24,4,3,0,2,9,1806489.79690812,6153558.8575527
0,35,4,2,0,7,13,2447724.12809879,9625288.22238484
0,35,1,3,0,6,10,1720957.38458811,7295959.65755736
0,19,2,3,0,0,5,1614587.97252506,4191646.69305832
0,21,4,1,2,1,8,1851694.40085717,3357558.38878787
0,10,1,2,2,2,7,1896916.93160588,2895176.77160845
0,33,4,3,0,6,13,2714563.57067659,4977599.88857211
0,36,4,3,0,4,11,2219728.61880867,6339261.36167925
0,18,0,0,0,2,2,1013343.19379011,3179345.16708947
0,18,4,3,1,4,12,2661072.89796836,5135274.17306828
0,19,3,2,1,4,10,2125606.84619627,5648034.09866441
0,10,3,3,1,4,11,1506095.56987085,5616040.36978195
0,34,0,3,2,5,10,2264083.17132041,6084630.60924806
0,14,3,2,2,2,9,1690198.25254818,6715773.39255438
0,27,1,2,1,5,9,1941964.34209646,6531224.48598748
0,38,4,0,0,5,9,1465562.68508327,7638773.12422795
1,21,2,1,0,2,5,1579089.70801528,6691877.43681541
0,29,0,1,0,6,7,2128543.66015432,5928574.35072694
1,37,6,0,0,4,10,1954191.20334297,7289862.9795804
0,36,2,1,0,3,6,1275097.87577183,2316592.766917
0,14,0,3,0,6,9,2127844.65568294,6406098.01362973
0,37,5,2,0,1,8,2376474.72656241,2960008.77219936
1,35,2,2,1,6,11,1577646.38179523,5591084.67085613
1,19,0,2,0,6,8,2248306.4033303,6351765.22728411
0,17,5,0,1,1,7,1772061.40662224,4507079.5809385
0,29,6,2,0,5,13,2329885.95674683,5884469.89573173
0,38,6,3,1,0,10,1837137.76079875,2933738.2650403
1,20,1,1,1,0,3,1171572.62820395,2610551.40624494
1,33,4,1,0,2,7,1791535.94831139,3972091.38894261
0,11,4,3,1,6,14,2288266.62570786,10007843.083334
0,38,6,0,0,7,13,1751583.58425716,4868483.58205245
0,16,6,0,1,5,12,1829930.59678056,7129998.43751184
0,27,1,1,1,2,5,1678001.76954505,1848442.87456103
0,35,2,0,1,4,7,1763168.78129102,2108940.49406442
1,21,4,2,0,2,8,1069455.91014819,5510810.4211242
0,39,3,2,2,1,8,1233382.06501499,5627267.76183979
1,39,3,0,0,5,8,2000584.62004258,7660801.84383317
0,30,3,0,1,2,6,1491342.96126291,5498166.25588547
0,12,3,2,0,7,12,1789542.3418868,6703523.67360821
1,28,4,3,0,2,9,1702454.46507821,8679886.56329224
1,26,4,0,1,4,9,2075783.89604844,2102623.21871005
0,34,3,1,2,3,9,2268456.36218847,3474085.93031423
0,40,4,3,2,4,13,2615679.40877526,5078912.34024796
1,14,4,1,1,7,13,1943584.70597366,7551087.20882128
0,36,2,3,1,0,6,857504.74440185,3831528.73080722
0,37,0,0,0,4,4,907981.466824154,5777851.78150273
0,39,1,3,0,4,8,2191646.25838535,5403213.54864829
0,36,3,0,1,7,11,2511779.82221306,2740771.95411358
0,29,0,3,0,5,8,2261406.84946853,6078487.2830881
0,33,6,1,2,3,12,2069470.86295628,6646195.38397156
1,32,1,0,2,1,4,1094085.96116223,3531661.32776513
0,28,0,2,2,4,8,2087144.16877722,4757764.06307173
0,15,1,2,0,6,9,2002631.31053302,6369019.5007046
0,38,1,1,0,2,4,1396792.47649958,5510885.17926126
1,20,0,2,2,5,9,1755379.28773448,4742685.83940438
0,37,1,3,1,2,7,1704181.14331923,5479020.8482724
0,31,6,0,0,6,12,2944834.42950213,6448557.01787539
0,19,5,2,1,7,15,3048236.09343825,2580648.0515812
0,25,2,0,2,4,8,1880320.57426929,4755415.61599222
0,39,0,1,1,5,7,1601059.25837029,3834946.32452876
0,30,4,3,2,2,11,1703847.97851331,10657865.9699158
0,27,5,3,0,2,10,2188013.64106432,3662189.22301584
0,10,2,3,2,0,7,1868574.85270034,3968226.4968094
1,12,6,3,2,4,15,2911192.13736784,5382818.31625083
1,10,0,2,0,6,8,1677428.99586243,7118022.94211752
0,10,1,1,1,2,5,1249164.55992801,2363452.07406261
0,32,1,3,2,3,9,1794405.47549986,6785035.95136751
1,23,0,2,0,7,9,2232190.64362466,6071134.92288227
1,30,0,0,2,5,7,1338142.48870088,5466313.02365174
0,39,1,0,2,7,10,1826131.10138104,5477009.29857509
1,10,0,3,2,7,12,3060404.68915979,6715871.11455431
0,39,0,3,1,4,8,1430712.05157579,6496373.44591012
1,27,6,0,2,3,11,2224915.37543681,8168316.83016157
0,22,3,0,2,2,7,2053389.92305279,5008080.40353786
0,20,2,3,0,7,12,2573791.40892453,6658866.2932326
1,29,1,3,2,0,6,1795745.57630609,8593769.5587037
0,32,6,0,0,2,8,2257701.03608463,2182411.58656245
0,15,6,0,0,1,7,1663985.91773958,7598893.28901922
0,37,1,2,2,5,10,2139598.59059377,6046689.69724498
1,22,3,3,2,0,8,1336065.3942735,6937745.21711268
0,30,4,2,0,4,10,1993147.213182,3507057.19027567
0,18,5,2,1,7,15,2159146.59303045,4010344.50104988
1,16,2,0,1,2,5,1445576.63941565,4390705.65682969
1,13,1,0,0,0,1,1084572.94183922,4222286.53430726
0,16,5,1,1,4,11,2113771.91482864,8593031.77252278
0,25,1,0,0,4,5,1433001.75426074,4516454.29357362
0,39,4,0,1,5,10,1677248.43737665,8572732.32157491
1,10,2,3,1,7,13,2519630.28474734,6560968.22212218
0,31,5,1,0,2,8,2077856.31359101,5060476.24694367
0,21,3,2,1,4,10,2064762.63935778,9305568.351389
1,24,3,2,0,4,9,1553709.08657901,9024532.15159046
0,28,0,2,2,1,5,1454692.24682967,4582624.86444525
0,23,1,1,2,6,10,1476487.21436526,7014687.07462795
0,23,0,3,0,2,5,1885288.42874644,4637672.93914619
0,33,4,2,0,2,8,1800017.19984697,4395858.2106929
0,26,1,3,0,6,10,2119719.68063693,7596939.63244946
1,20,1,3,2,0,6,1628518.45599314,4371330.40474715
0,12,1,1,1,5,8,1393690.06048999,7874862.09421589
1,11,5,0,0,2,7,1876097.13820869,3215856.78263247
0,34,4,1,2,3,10,2557380.77007044,5389414.47593975
0,31,6,3,2,7,18,3047721.95979848,9290031.09484019
1,20,2,3,0,2,7,1501678.80270513,5872697.5944913
1,15,0,0,0,0,0,809954.593413069,3437082.11466145
0,20,2,0,2,4,8,1328808.67301249,4271528.17080751
0,10,2,0,1,0,3,1460278.99390592,3394744.61561834
0,35,1,2,0,3,6,1916597.58903996,6182514.64166888
0,37,5,0,1,1,7,1739226.76402291,3932506.09718462
1,23,1,2,0,2,5,1006895.07291039,3286975.47705855
0,14,0,1,1,1,3,1213251.862194,3904933.40402152
1,35,2,3,2,2,9,1882758.32175688,7933253.7026357
0,38,0,3,2,0,5,1634583.48915695,3597831.3567716
1,32,5,2,1,7,15,1647036.09028136,7284171.8428119
0,13,5,2,0,5,12,2324395.65798732,9226568.86914692
0,22,2,3,2,6,13,2598498.90054978,5635730.47210133
1,24,0,0,0,7,7,2054055.5182659,5872319.81066354
0,11,3,0,0,4,7,1496011.13641125,3159588.47109305
0,23,6,2,0,6,14,2409882.09958552,6883292.18500071
0,16,6,3,1,7,17,2190924.33478233,8802085.59687599
0,19,0,0,2,3,5,1534718.2059096,5245193.15919281
0,28,4,0,1,4,9,2379312.71670272,6552440.39172474
0,11,1,3,0,5,9,1851608.44728443,4793089.97632668
1,15,6,3,1,6,16,3130994.81596788,11270637.6063805
0,27,2,2,2,7,13,2575495.28590253,5695177.69593164
0,30,1,0,2,0,3,1358723.04052469,5325778.09354928
0,15,6,2,1,0,9,1737069.45881563,7862621.45597154
0,18,5,1,1,2,9,1276348.26021259,5722873.94084555
0,32,6,1,2,7,16,2198487.16502362,10882787.2001132
0,10,3,1,0,1,5,1376243.05615168,3193607.52216667
1,22,5,1,0,3,9,1655701.85976997,5933765.46807464
0,13,5,2,0,0,7,2067512.69793101,9138679.96320673
0,15,1,1,2,5,9,2327234.70994048,5621685.44483814
0,23,4,1,2,5,12,2383582.68025903,6523210.95175184
0,11,5,0,1,6,12,1944529.54611732,3468165.31152246
1,32,3,1,1,0,5,1242293.3551047,5912284.7317617
0,15,3,0,1,1,5,1598107.36133104,1598107.36133104
0,30,5,0,0,5,10,1710442.69733219,7098737.4016169
1,26,4,3,2,2,11,2481231.46706186,9088521.4299102
0,26,4,2,0,4,10,2003607.76931226,3588822.01141794
0,27,1,2,2,4,9,1920579.51957107,3044270.30276421
0,37,1,0,0,2,3,1532715.79232997,1655406.45244045
1,15,3,0,2,4,9,1994304.81366563,3848095.19015251
0,40,0,1,0,3,4,1345473.57625887,1389890.98406053
1,29,1,1,1,7,10,1822464.91153764,6860954.25468202
0,32,1,0,1,6,8,1421368.91139914,3153640.93979107
0,25,6,0,1,0,7,1938655.45358571,4682150.71671803
1,11,2,1,1,4,8,1851327.42534095,3366966.83310304
1,23,4,1,2,1,8,1372151.34883695,6194634.39686585
0,29,2,2,2,1,7,1435184.52408958,4489771.5146827
0,30,1,3,0,4,8,1309409.8981314,5547402.84492313
0,22,2,2,0,2,6,1902201.17890085,2786185.39204733
0,35,1,3,1,3,8,1698538.30514079,8637985.81786179
0,38,1,3,2,4,10,1962338.38335061,8364635.04360486
0,38,1,2,1,3,7,1431826.84783928,3765313.86682312
0,35,5,0,0,3,8,1784400.16657062,4030259.74745185
0,38,6,3,2,4,15,2136190.45594742,4687555.92058318
0,30,5,2,1,3,11,1920609.56124635,8061636.00427096
0,16,5,0,2,6,13,2511382.0059164,9877342.47418131
1,36,2,2,0,4,8,2153724.4504169,6444439.75423458
1,35,4,1,1,6,12,2297626.54638916,7952130.4558471
0,11,3,2,2,1,8,2106216.63233731,4971975.98028186
0,33,5,2,0,4,11,1995566.727201,3996499.49383465
1,23,3,0,0,0,3,1049119.73963736,3225945.51442453
0,14,2,0,2,7,11,1290811.22781888,8025726.33592949
1,21,3,0,2,7,12,2573205.52451725,5623298.71067956
0,35,2,3,1,1,7,1671661.42691386,7124685.02250691
0,29,2,1,0,2,5,1768415.30728181,4886113.0444007
0,33,1,3,1,7,12,2143270.37948475,6028278.79636483
1,37,2,1,2,6,11,2087450.64265692,7078849.25142914
0,29,6,1,1,0,8,1534739.74270146,5562386.68465017
1,20,1,0,1,2,4,1388286.07764938,4772647.26711071
0,13,2,3,2,2,9,1400825.25663955,3490776.11176083
0,17,4,1,1,2,8,1496479.67628568,5909283.44983029
0,37,5,0,0,7,12,2285535.97665305,4913209.26108142
1,31,5,3,1,4,13,2118851.97499184,9087177.23434063
1,36,5,3,0,1,9,2262524.00713616,4616044.98697085
1,33,4,3,0,7,14,2355132.57503671,5424415.6505531
1,31,1,2,0,1,4,1717533.34883265,3891390.09161598
1,38,2,2,2,7,13,2115049.77714472,4545416.95011732
0,19,3,2,1,4,10,1594511.82921476,9346305.71708866
0,19,0,1,1,6,8,2017361.83623946,4947872.70032104
0,25,5,2,2,4,13,3030587.11702619,5085279.4941188
0,33,1,0,1,1,3,1204489.428329,6274657.21924036
1,37,4,3,1,3,11,2237027.70434219,7842419.37213095
0,11,3,2,1,7,13,1928698.32788953,7309427.69275304
0,12,2,1,0,2,5,1668980.53311006,5300642.18414276
0,39,3,1,1,6,11,1769499.64105911,6213776.67180723
0,22,4,2,2,7,15,2492465.11097698,8291242.26680631
1,36,6,1,1,6,14,2568010.09649326,7771543.64822586
0,25,3,0,0,6,9,1889120.46988762,4780368.94329732
1,35,6,2,0,1,9,2240972.82583171,6924258.74479028
0,27,1,2,0,4,7,1503003.76850663,4172576.43502357
0,31,4,0,1,6,11,2125934.15402665,3025802.93534007
0,37,2,0,1,2,5,1606713.27839777,10469579.6617028
0,21,1,2,2,7,12,2221349.83923807,6722229.4651854
1,35,0,0,1,3,4,1412523.09417493,5048196.96527114
0,14,2,0,2,3,7,2293565.57275178,6885093.08257804
0,39,3,3,0,6,12,2155839.26882715,8759891.1321227
0,36,2,0,1,6,9,1634483.99786937,7532069.21551333
0,19,5,1,0,7,13,2121380.62736805,8772263.58679
0,10,0,2,0,7,9,2487775.09543896,6254427.06327755
1,19,2,1,0,7,10,2049103.28553899,5373976.45699533
0,14,0,2,1,1,4,1436280.04721262,5084799.04456685
0,14,1,0,1,4,6,1341497.60208828,5051878.89849383
1,31,1,0,0,4,5,1664970.44513884,4336162.56370793
1,31,4,2,0,5,11,2164108.19982293,7235149.73193289
1,32,2,2,0,4,8,1191577.39723627,6045712.4771931
0,40,3,0,1,5,9,2131244.2792988,6066926.45688263
0,11,5,0,2,4,11,2309753.2813568,6454111.74489878
1,25,3,0,2,5,10,2226867.23680178,6266026.91591121
1,22,6,3,2,7,18,2361095.71179769,8232011.47459302
0,20,2,0,1,2,5,1256303.6393981,2543764.57951839
1,23,1,0,0,0,1,861167.034736588,3968659.73498702
0,25,3,3,1,2,9,1684786.75699653,6383582.99903824
0,38,1,2,1,3,7,1550464.49940371,5322115.65393482
0,32,6,0,0,5,11,2096180.95176721,6851429.86596681
0,14,1,2,2,4,9,2304733.7159033,3699562.84930772
0,26,3,3,0,2,8,1489906.63721338,4347659.96387336
1,28,1,2,0,1,4,1206503.03058046,6409807.558368
1,29,1,2,1,5,9,1762123.0045479,4431069.50933781
0,38,4,1,1,2,8,2198258.74875158,5592200.38926062
1,24,1,0,2,0,3,1533607.17742015,2996038.37319142
0,11,3,2,0,2,7,1765299.3271896,5959553.19324101
1,34,4,1,2,2,9,2107109.09285157,8471601.62714513
1,25,1,0,1,4,6,1883518.69899133,4784858.51104371
0,30,1,3,0,3,7,1528081.16848456,5881363.45249835
1,13,4,2,2,0,8,2109123.00650243,4048844.02170823
0,39,6,1,1,7,15,1822111.65934595,7747284.51811732
0,32,4,1,1,4,10,2417083.68846666,6098860.74897225
0,12,3,2,2,6,13,2353039.61694216,7375715.3261681
0,34,1,3,2,5,11,3234435.13337235,5787724.84277601
0,11,6,0,1,3,10,2604400.9691621,8930055.1643449
0,33,0,2,1,2,5,1555615.26231188,4664652.05043656
0,25,5,3,2,4,14,2239837.60822741,6344462.08761006
0,33,3,3,1,2,9,1685835.73597176,6068558.88161991
0,16,4,2,0,6,12,2839954.41057189,8553363.38992809
0,25,3,0,1,3,7,1775119.78684363,4829305.5612035
0,22,5,2,1,7,15,2475314.01656892,11981588.2625983
0,20,2,1,1,6,10,2219148.19964498,4360146.00762739
0,21,1,2,2,5,10,2036194.81091349,6774242.4369432
0,40,0,1,1,3,5,1491685.31942137,2758987.20710675
0,11,1,0,2,6,9,2207426.00163919,1993959.5705986
1,16,5,3,2,2,12,1740665.35180555,6506549.14343
0,16,2,1,1,0,4,1365809.26326319,5034951.68912724
0,26,2,2,2,1,7,1770709.48013255,3761803.79047209
0,12,0,2,1,1,4,1618721.16028557,3951598.63744443
0,18,4,0,1,6,11,1873251.83206994,5880826.82626948
0,31,5,1,0,3,9,1676771.12535579,6253047.91372366
1,24,3,2,0,4,9,1612330.88707286,2551609.17220113
0,17,1,3,1,1,6,1479055.05124041,4979091.09015113
0,18,3,3,1,5,12,1796753.95557991,6572602.70895916
0,18,4,3,0,6,13,1961190.29408229,7990185.49260858
0,26,5,1,0,7,13,1700336.51025615,5512078.58699179
0,19,0,0,2,1,3,1180313.43651012,3130711.41484336
1,23,4,2,2,5,13,2837554.03118162,4182162.31105373
1,40,6,3,0,6,15,2186044.29723535,11391468.8962692
0,28,4,2,1,0,7,1863598.4087209,5628511.86710164
1,25,3,1,2,2,8,1724415.37143871,3032834.08649757
0,11,5,2,0,2,9,1620053.21986764,5729652.83892719
1,25,6,2,1,2,11,2077972.69935106,7212521.89200167
0,19,2,3,1,1,7,1618895.8126824,2841490.92198885
0,35,2,1,1,4,8,2401968.39439939,6780585.18112698
0,39,6,2,0,2,10,2004382.13117506,4354895.38490781
0,31,5,0,1,0,6,1552193.88976185,4471285.06981783
0,35,1,0,1,6,8,1571437.33189686,4080201.10195334
0,28,1,2,0,3,6,1321334.50233128,4675225.68507334
0,22,4,1,2,4,11,1680250.95733017,5523581.20715202
1,21,2,2,2,7,13,2073358.73914651,7866764.16109277
1,22,0,3,1,3,7,1649766.55480033,4257131.85886736
0,33,5,1,2,4,12,1772253.52176717,8498578.55403251
0,26,6,2,2,5,15,2618973.67552262,8792201.16428116
1,17,4,2,0,5,11,2743890.90184436,5999052.65602854
0,23,5,0,1,7,13,1829086.5372799,9265042.90644428
0,16,6,1,1,5,13,2474092.18476206,6864139.27356049
0,10,1,3,1,1,6,1907383.19430486,5556332.36334002
1,36,4,2,2,4,12,2421796.19946842,3886204.53984137
0,35,2,1,2,1,6,1797990.17672323,4348197.42622741
0,28,1,0,1,2,4,1733653.24612255,5175674.87639068
0,13,5,3,2,2,12,1502932.63316453,9525087.58192507
0,30,1,0,1,0,2,1607889.60799204,4833869.68865632
0,18,5,3,1,4,13,1434183.08201181,7704060.43317838
0,10,6,0,1,1,8,1490512.86068779,6870539.38850256
0,21,5,3,2,2,12,1971553.73288184,6069975.76926105
1,21,3,1,0,1,5,1263504.2822799,2718328.91981098
1,38,1,1,2,7,11,1908950.9106509,7810837.77468834
0,35,2,0,2,7,11,2383165.04672449,5763980.12889171
0,18,1,1,0,1,3,1480946.7152806,869354.972840603
1,40,2,1,2,4,9,1884846.20231624,6205900.51362421
0,34,0,3,0,7,10,2030010.62646322,6610430.94331501
0,14,2,0,1,6,9,1955328.63611606,6117098.4055522
0,15,5,0,1,5,11,2409869.03624354,3388528.48948895
1,29,5,1,0,2,8,1691778.93184963,4118989.52314834
0,22,3,2,1,0,6,1766394.74919513,7339713.04825429
1,23,4,1,2,4,11,2041144.16579662,6522695.53459174
0,40,6,2,1,4,13,2566579.86464869,5430741.91999347
0,17,1,1,2,1,5,1755037.74097579,3747392.89833235
0,17,2,1,1,4,8,1807056.87813182,5565162.16736273
0,34,4,1,2,1,8,1817441.12820203,160498.912256231
0,15,4,3,1,7,15,2330005.95872475,5474069.90333957
1,10,0,2,1,1,4,1711320.72422878,3068649.025416
1,20,4,0,1,2,7,1656765.33942082,1656765.33942082
1,24,1,2,2,7,12,2514446.43147694,9236799.91651836
0,25,1,0,1,7,9,2182269.10781711,4970189.59318478
1,40,2,3,1,5,11,2329164.74146755,5699438.00858121
0,17,5,0,2,2,9,1993260.44154418,4150932.52227039
0,10,0,2,1,5,8,1873762.96924466,5624446.08735861
0,17,5,1,0,5,11,2131282.0738653,7887604.43058341
0,28,4,0,2,0,6,1561606.83947235,5570838.738656
1,18,1,0,1,0,2,1227644.48801861,2511308.13947696
1,36,1,1,1,2,5,1572609.90045073,5495349.30304182
0,25,6,2,2,7,17,2606310.63914293,7788525.27611462
1,13,6,0,1,1,8,1780927.50818221,3245310.18138571
0,40,1,2,2,3,8,2064323.65958875,5204088.25548155
1,35,2,2,0,2,6,1440225.55629489,1386902.41091906
0,38,0,0,1,7,8,1636327.16223927,6198292.52327277
1,31,0,1,1,4,6,1741686.31109556,5603196.1555322
0,30,3,2,0,7,12,2193667.43493408,7876037.1104537
1,20,5,0,1,0,6,1356114.09832874,4189157.59606429
0,40,1,2,1,5,9,1627468.63462961,5701025.85827907
1,27,4,2,1,2,9,1444221.55540456,7267328.43540914
1,23,2,0,1,7,10,2291560.07865965,6831962.45286312
1,25,0,3,0,2,5,1127836.77193858,7709855.72258348
0,39,3,3,2,7,15,2725443.40145062,7915919.54981239
0,33,1,2,2,7,12,2499244.99866766,3745238.4354705
0,39,3,0,1,5,9,1421298.04694345,3313763.29887012
0,11,6,2,0,1,9,2200224.26351873,4707754.55719982
0,15,2,1,0,1,4,1612443.52078336,10469894.2477029
0,10,6,1,2,5,14,2989327.81060198,7649924.85117309
0,17,6,1,2,4,13,1872398.09415384,3417457.15260798
1,11,0,1,1,6,8,2116548.56062774,6646377.57230983
0,12,2,1,2,7,12,1983483.67217503,4495516.56043098
1,31,3,2,1,4,10,1528682.66917298,5960421.11474959
0,39,6,2,2,4,14,2949074.67485301,7794429.37020979
0,28,4,0,1,2,7,1462127.38329545,6777423.57934205
0,23,5,0,0,0,5,1185756.62383736,3840064.9805226
1,33,1,0,0,0,1,980235.090400955,4271737.28121759
1,38,5,1,1,2,9,2148726.31579141,5962987.98654339
0,26,2,3,2,3,10,2140878.49316667,4097733.30144931
0,21,2,1,2,5,10,1842084.19763557,8748858.16188186
0,14,6,0,0,7,13,2465111.17718984,9568432.65109944
0,18,5,2,1,2,10,2289662.81964973,3815149.38920572
0,29,4,3,2,4,13,2301680.87384024,5783948.88972431
0,13,5,0,2,4,11,1721413.21393637,6298757.06135507
0,18,5,0,2,0,7,2067489.11042084,6460745.00362853
0,20,1,0,0,0,1,801864.752107069,4609283.0063311
0,34,5,3,0,7,15,2842759.14650566,4787926.80200776
0,30,4,2,2,5,13,2448701.62992993,9792715.76113866
0,21,1,2,0,2,5,1515574.7283126,4745605.86102926
1,26,3,1,1,2,7,2266966.09678522,5174487.16153966
1,25,6,0,0,5,11,2356337.06519771,5174494.45477111
1,28,3,2,0,5,10,1998884.11100489,7425516.93477418
0,31,1,2,2,1,6,1743928.48866031,6629011.67664531
0,36,1,2,1,2,6,1972756.31129807,5176954.41302358
0,13,3,0,1,4,8,1639640.04962129,5724298.79037275
0,25,5,3,2,3,13,1810435.21247572,7013993.31603801
0,39,0,2,1,5,8,1734119.82163427,5627510.06147797
0,21,0,3,1,0,4,1444681.98770938,642339.232904659
0,19,5,2,2,6,15,2747553.46242016,8853004.56132135
0,23,3,1,2,4,10,1961019.19385817,5924100.17084624
0,31,6,1,0,5,12,1601580.68555496,6262888.62268705
0,30,6,3,0,1,10,2370042.10609124,6885644.98903331
0,12,4,2,2,1,9,2226820.57220231,11063783.1195997
0,34,5,2,1,7,15,3105061.92050129,6795498.89128828
0,38,4,2,1,6,13,1805792.01953319,6585507.53778902
0,29,3,2,1,5,11,2011781.41828631,3670810.21047786
1,15,4,1,0,4,9,1764798.45400866,7583078.8267527
0,29,2,2,0,5,9,2192435.12590342,9584813.38448443
0,29,2,0,2,3,7,2157699.41973233,4339422.3899969
0,40,2,3,2,7,14,2567560.56959081,7945242.76813047
1,32,1,2,2,0,5,1404718.26361903,7351094.12881113
1,31,2,1,2,0,5,1401032.64396136,6596459.63540461
0,23,6,2,1,3,12,1655090.04304203,4661521.01076233
0,30,0,1,0,4,5,1964035.83396572,5468276.4645609
0,35,1,1,0,1,3,1300924.16489754,1972190.28943923
0,33,0,2,0,5,7,1830064.15114808,7862779.23541815
0,26,2,3,1,4,10,2646356.85376327,9362202.726987
0,31,0,0,2,6,8,1795154.0650435,2253525.83775543
0,31,5,3,1,3,12,1990856.42762632,7150965.1632428
1,10,4,2,2,3,11,2198980.70767514,8323097.7684666
1,21,1,3,0,5,9,1412814.82074703,9137891.97427241
1,33,3,2,0,7,12,2613607.46503029,4363043.80412808
1,15,5,0,0,5,10,1488554.17076437,6505472.09535495
1,24,5,2,0,5,12,2193502.76350249,8142222.79706323
0,12,3,1,1,1,6,1865787.98202712,6035928.27732252
0,35,6,2,2,6,16,2279985.38122115,10856209.3028045
1,28,1,3,0,1,5,1877866.02900438,592405.44350516
0,23,6,0,0,0,6,1219927.55126192,9465035.33208074
1,27,5,3,2,1,11,2119842.1905086,6789667.38965222
0,10,6,2,0,6,14,1534873.35937267,6431296.28831733
1,35,4,0,1,2,7,1544295.165189,2046528.11687917
0,35,6,1,2,5,14,1787198.84394092,7192683.3171184
0,13,3,2,1,1,7,1263866.66100594,5412344.75394166
0,23,4,3,0,2,9,1197521.25427632,8330376.30450901
0,13,3,2,0,5,10,2139833.77354571,5392384.68733396
0,28,3,1,1,3,8,1560391.64620592,3370638.66855179
1,28,5,3,2,4,14,1840804.52595138,8494711.25678933
0,20,4,0,2,2,8,1936617.64199591,3958800.60340048
0,29,6,0,1,7,14,2721286.88868055,9635087.22740595
0,22,3,0,0,3,6,1821491.45821255,4554876.99095353
0,38,3,2,2,1,8,1508440.42768494,6850499.05621965
0,26,0,0,2,7,9,1761738.50529605,4370205.66728002
1,12,1,2,2,0,5,943995.69114944,5302439.77988687
0,40,4,3,1,6,14,2727636.20713258,4667586.59348332
0,32,5,3,1,7,16,2796187.21917104,12564522.4149323
0,40,6,2,2,2,12,2257453.96061973,9029390.62372221
1,21,1,3,0,5,9,1631193.53313056,7720600.83202823
0,18,2,1,1,3,7,1548885.88550232,4581806.7727884
0,10,1,0,0,2,3,1216193.37267674,4827381.55130801
0,28,2,0,2,2,6,1600318.7243078,5958660.94133547
0,34,0,1,2,6,9,2039369.34055851,4324612.35088263
0,39,4,0,2,3,9,2078191.20203453,10602645.0607488
1,24,4,2,2,0,8,1803836.60184209,6024385.51982518
1,15,6,2,0,5,13,2352421.26114394,11675507.2518802
0,34,0,0,1,2,3,1770559.35821409,2362592.1509622
1,32,2,3,2,3,10,1817264.22444117,6074474.57167517
0,28,1,0,0,7,8,1923561.68140174,6364704.22744535
0,12,1,3,0,0,4,1619159.51879086,5138585.4321074
0,23,0,2,0,7,9,1946501.16349945,4259546.28741955
0,27,0,1,2,7,10,2123169.74415239,12542496.2519522
0,23,3,2,2,7,14,1474979.52297582,9001762.04978687
0,22,1,3,0,6,10,1651069.17782857,5263773.65987048
0,30,2,2,0,5,9,1824391.48452368,7554794.24644221
0,10,6,2,2,4,14,2335932.31606943,6781188.84917604
0,23,3,1,2,6,12,2530025.99087471,8230363.7591471
0,14,5,1,0,4,10,1747674.9548483,4940149.64577932
0,12,1,0,0,5,6,1693445.17425317,5521784.01130137
0,38,0,3,2,0,5,1235218.56741695,5319789.25435446
0,32,2,2,2,4,10,1779407.89560597,3483406.76355698
0,29,2,1,2,1,6,1422058.09330672,4974395.1559441
0,16,1,1,0,5,7,1633308.63817452,7160407.12404838
0,23,5,0,1,3,9,1855593.60256099,4130100.69518272
0,36,0,1,0,0,1,1030129.71331942,2984519.93338207
0,25,2,3,1,3,9,2216176.14418534,4292314.47772889
1,16,0,2,0,7,9,2391847.57363548,6579253.53718803
0,21,0,0,0,0,0,669712.030921871,1033168.68196854
0,40,2,0,2,0,4,1061719.20036929,4381053.8942258
0,10,0,3,0,3,6,1516698.86298424,2672167.05895807
0,14,2,3,2,2,9,1885561.43670871,5256716.18664601
0,36,3,3,0,7,13,2381643.76768414,5203490.13978643
0,13,1,3,2,7,13,2167586.20890568,8367827.87696419
0,28,3,1,1,1,6,1843847.54661403,5950793.48024742
1,30,0,3,2,3,8,1305226.61836187,4806843.2454558
0,16,3,1,1,7,12,2245783.23433257,6943629.5592115
1,30,1,3,1,5,10,2618594.96589918,5359722.80055266
1,32,5,3,0,7,15,2253365.58505748,4040508.46859892
0,27,6,3,0,4,13,2617857.01817928,7495023.68712973
1,12,1,2,2,0,5,1721406.06877573,5810684.71263052
0,19,4,1,0,5,10,1604962.13561908,8397056.6594517
0,19,4,2,2,4,12,2071839.27254452,3280128.59483935
1,34,3,0,0,0,3,1548787.5054788,3303722.29443626
0,20,2,0,1,2,5,1790753.7538543,6682024.49430333
1,38,4,0,2,7,13,1808083.3715674,8372803.83181471
0,28,1,3,2,2,8,1841578.87525423,4998907.04981898
0,15,6,0,2,3,11,1958526.88897427,7750004.79692596
1,31,3,3,1,4,11,2459382.77302012,7489327.07010487
0,18,3,0,0,4,7,1639138.03792859,5693632.99743783
0,23,1,3,2,3,9,2473622.03001358,5427363.51091014
1,32,2,0,2,7,11,1902999.750174,2636421.68694521
1,28,6,1,1,6,14,2285952.4773089,8155355.25246791
1,25,1,3,0,4,8,1356767.65595591,6143141.39390968
0,31,3,3,1,6,13,2283141.22051826,3617095.53291355
1,12,5,3,2,6,16,1576542.73181621,6848917.32636962
0,27,3,3,2,1,9,2005833.49612392,6317090.98319014
0,19,1,2,1,6,10,2451406.43953928,5881071.9977979
0,21,4,2,1,2,9,1751242.18532855,6051881.29551074
0,21,4,3,0,5,12,2807757.94260688,6926193.91775255
0,37,3,1,1,4,9,1800337.8962648,4866443.82943893
0,20,5,3,1,4,13,2035969.0337897,4504980.56308812
0,26,2,0,0,0,2,1532492.12233817,5618471.52028799
0,36,6,1,1,6,14,2345964.69896805,9098910.12554095
1,22,4,2,1,3,10,1964639.84332452,8516814.60738858
0,33,3,0,0,1,4,1223458.42978427,3565877.22188597
0,35,1,0,2,3,6,1780747.01162305,5398133.34007738
0,11,0,3,1,2,6,1468013.83705673,6736732.53863495
1,26,6,1,1,7,15,1939124.01420954,9711083.30844567
0,33,6,1,0,2,9,2572831.12810552,3871253.57855521
0,23,6,3,0,0,9,2100372.75551243,4940671.75904184
0,14,6,0,0,7,13,2213057.93748705,3038471.92511443
0,10,1,3,0,0,4,1226792.84317595,2347186.86982725
1,32,2,0,2,2,6,1522338.5155397,3668924.31887339
0,28,0,0,0,2,2,1429809.52046345,4574002.84464945
0,14,3,0,0,1,4,1709053.9669518,6356943.29497751
1,26,5,0,0,7,12,2803511.29010044,8671677.57537222
0,36,6,0,0,1,7,2342031.93817356,6346003.94320183
0,11,2,3,2,1,8,1811869.19339974,6862276.55646071
1,28,1,2,0,6,9,1457035.89669951,3713243.85572228
0,13,4,1,0,3,8,1473258.58201031,3426675.62070882
1,23,3,1,0,7,11,1733867.00095147,5661769.24428577
0,19,6,3,2,0,11,1994426.02265555,7034467.43866966
1,14,5,1,0,6,12,2311324.47007413,5979074.77524914
1,29,2,0,1,3,6,1881450.4894447,3380604.57125902
1,26,2,3,2,5,12,2906071.41382414,6937811.15297027
0,30,5,0,2,4,11,1482826.53703888,4598697.69508484
0,13,5,1,1,4,11,1992379.49652215,3296596.63081601
0,39,0,0,2,1,3,1573103.33272921,5458478.0938969
0,17,3,1,2,7,13,2145973.39939151,8704494.25586643
0,29,0,2,1,6,9,1949054.79255213,3998511.3560426
0,15,5,3,1,1,10,2099599.18438404,6375224.22508773
0,13,4,3,1,3,11,2050154.69676134,5004729.97879053
1,35,5,2,1,4,12,2630507.90536119,5488947.31828794
1,40,2,3,2,1,8,2182462.81657231,7444569.75874765
0,21,0,1,0,0,1,1141872.15651323,4200742.91480359
1,25,1,1,0,5,7,1591631.11547534,6657640.25694413
0,17,0,2,0,7,9,1896568.71290346,4653845.06238159
0,40,4,1,2,7,14,2565142.63813258,4600564.8572182
1,16,0,0,0,0,0,1171979.93266025,1076396.68131611
0,37,6,3,2,6,17,2496319.88461819,9018979.49424348
0,22,0,0,0,3,3,1459863.49738732,4380317.98127152
1,18,5,0,1,1,7,1953111.67529103,5833608.4247672
0,31,5,2,1,0,8,1366920.91048973,3296699.34915869
1,25,4,3,0,2,9,1522176.18672717,5509199.04197118
0,33,3,3,1,6,13,2926330.40278113,6835673.73868056
1,11,3,1,1,0,5,1487356.40137362,3444926.30518351
1,18,6,0,2,7,15,2458358.06985328,7276339.76487059
0,11,4,2,1,3,10,2094546.72166089,9266670.66390098
0,17,5,1,1,7,14,2689435.40184987,8593006.39083403
0,19,4,2,0,4,10,2155717.33680709,3422482.05498822
0,34,0,2,2,7,11,1698368.1329786,5730972.71295218
1,16,0,1,2,1,4,1275311.90917012,3750867.39911308
1,40,5,3,0,1,9,2096859.95604735,6537833.27246976
1,37,5,0,1,3,9,1868666.36697102,7683725.78930848
0,31,3,1,1,0,5,1380924.32422352,6380577.2537419
0,25,5,2,0,6,13,2195573.5182778,10817859.3539617
0,27,1,2,2,0,5,1452944.84873678,6247922.12864623
0,18,2,3,2,1,8,1926195.38529335,4117388.23391622
0,32,0,3,2,3,8,1429914.43105289,4456972.26160061
1,38,3,3,2,6,14,2273917.80019715,7743700.62095689
1,36,2,3,0,5,10,1946139.03940654,7421371.9622993
0,38,0,2,0,1,3,1352177.04815711,5439955.9195939
0,37,4,0,2,7,13,1730121.90190819,8098659.62057971
0,24,1,0,2,2,5,1610487.32486848,5464875.3722553
0,27,4,1,0,6,11,1978776.70160474,1981172.5899541
1,31,3,0,2,1,6,1520780.46157206,5502329.4768547
0,33,5,1,2,0,8,1926520.51193368,6342220.51848208
1,28,5,1,1,3,10,2030643.18501171,7200202.53149165
0,10,5,2,2,6,15,2288713.67137904,5789874.0731199
1,38,5,1,2,1,9,1408460.68996893,4976792.45121909
1,15,4,1,2,1,8,1856041.68661516,6471274.53495613
0,32,5,1,2,6,14,1802301.49076739,7135885.09834649
0,26,4,2,2,0,8,1665888.4173413,4106985.81529974
1,10,3,0,0,0,3,1688883.21333048,664195.152158411
0,18,5,3,2,0,10,2139877.71337514,4620540.54995005
0,39,5,3,0,3,11,2512383.50928307,4913499.01190859
0,38,5,1,2,6,14,1957406.44866242,5518031.51571538
0,11,6,3,2,6,17,2341663.52965761,9083782.80863188
0,39,4,2,1,6,13,2482108.36256876,5695995.87814973
1,30,1,0,0,3,4,1512651.24067524,6221111.44270862
0,22,1,2,0,2,5,1868809.79314517,3862373.47732579
0,29,3,3,0,0,6,1754670.22964268,3735860.42038053
0,19,5,1,1,0,7,1426709.69917753,3501742.89841166
0,33,6,1,0,4,11,2283521.03576745,9909565.58893452
1,40,3,1,1,6,11,2409197.72840508,8027830.50528673
0,10,3,1,2,1,7,1940882.86478274,5539475.06953748
1,29,4,3,1,5,13,2551433.00925894,8211600.83295676
0,16,0,0,2,0,2,1288527.52718255,4273879.66516524
0,28,0,0,1,3,4,1279096.67295729,3737075.91905292
0,15,4,1,1,5,11,2470062.6435381,9239104.88125197
0,31,4,0,1,6,11,1987115.72718304,5453909.31637245
0,22,2,3,0,3,8,1673286.07505667,10868084.4200723
0,33,3,2,2,3,10,2150923.56108664,6894967.02471367
0,18,2,1,2,1,6,1760088.58250187,5964546.59584571
0,22,1,2,0,3,6,1529128.45831565,3149155.93935999
0,37,2,2,2,2,8,1746768.51819963,4490434.98995084
1,27,3,0,1,3,7,1299548.09551989,6571152.37653079
0,21,0,0,1,0,1,1213938.05485244,1920624.97100546
0,12,6,1,1,1,9,1757251.20211811,5882496.86423613
0,26,5,1,2,5,13,2607185.36298816,4224217.69781807
0,26,4,3,0,4,11,2207152.95872403,9209575.59888692
0,38,2,1,2,7,12,2149172.59419969,4068351.13093982
0,33,5,3,0,1,9,1481742.34549854,2481272.06065955
0,13,6,1,0,7,14,3144231.68322983,9192493.09671355
0,17,6,3,1,0,10,1369293.13224629,8852624.54955974
0,14,2,3,2,3,10,2117529.71412096,5589013.41812643
1,29,6,2,2,0,10,2503735.38355888,7249316.57215573
1,38,2,1,0,0,3,1289544.00198244,6207075.44289075
0,35,3,0,0,5,8,1603920.18238319,5690895.33345846
1,31,6,2,1,5,14,2537489.86217179,11433370.2871933
1,33,1,3,1,7,12,2038343.29252751,5804393.06123561
1,20,4,1,1,6,12,2862229.18513827,9453238.47555122
0,15,0,1,0,3,4,1636689.69300978,5372295.9122546
1,36,0,3,0,5,8,1738588.04765993,2959376.19787504
0,21,4,0,2,0,6,1611092.92678359,4888278.17029667
1,40,6,2,1,5,14,2531298.0658874,9158045.06899924
1,39,2,0,2,3,7,1536163.00068318,4570798.96408162
0,14,6,3,2,4,15,2130553.77027054,7746236.33262655
0,13,2,2,1,0,5,1411234.70281297,4029252.78387711
1,17,1,2,2,3,8,1349944.75830783,6958851.35033021
0,20,2,2,0,1,5,1594445.31802268,5383759.50191307
0,21,3,3,0,4,10,1348728.72249951,4106782.47628071
0,14,3,1,1,3,8,1786803.9718961,7262115.38029654
0,20,2,3,0,4,9,1764499.76773661,2889049.06868944
0,30,1,2,1,0,4,1247775.98336308,1247775.98336308
0,35,3,0,1,1,5,1581130.33467668,1197007.92865922
0,25,4,2,0,3,9,1640230.29535553,6854893.86650233
0,22,2,2,2,2,8,2013207.91189328,6186990.58455587
0,10,3,0,1,2,6,1572222.06914808,6203362.05549788
1,24,1,1,0,1,3,1376427.98977238,2953508.01152758
0,38,6,3,1,7,17,2662324.02014088,5403399.19116754
1,30,5,1,1,1,8,1713019.15031433,4545548.81738774
0,26,2,0,2,6,10,2280184.50139854,6479365.40640065
0,29,1,1,1,3,6,1972158.44617918,3736717.85180878
1,11,1,1,1,1,4,1708690.34421167,4479951.54129159
0,18,4,0,1,3,8,1972358.94719977,6981563.71226513
0,36,0,0,2,6,8,1853497.25850209,4028318.96331946
0,25,5,1,1,2,9,1805220.16934995,8499900.18795399
0,15,6,2,0,4,12,2004622.03670679,7115251.5876578
1,27,1,0,0,2,3,1147275.25074644,5660658.99497101
0,32,0,3,2,7,12,1701168.38216492,7453283.20645264
1,14,2,2,2,2,8,1863998.42600193,4806006.17065043
0,21,4,3,2,2,11,2158962.50437232,9102461.65473916
0,11,5,1,0,7,13,1991997.8843195,10227045.3731481
0,19,2,0,0,3,5,1752793.45344931,6135895.96497492
0,32,2,0,2,4,8,2172261.12673593,4039316.0010622
0,14,5,3,2,7,17,2462892.5708042,9332975.91924474
0,27,4,2,0,1,7,1680224.719149,6309899.46803688
1,18,0,1,2,7,10,1704955.11466401,5086252.07607796
0,32,0,1,0,5,6,1695985.12750308,5704284.2996865
0,11,4,1,1,7,13,2305303.77631079,6621466.58081654
0,36,1,3,2,0,6,1786906.03676992,3110897.58828538
1,40,4,1,0,1,6,2077632.35622819,4312220.79010685
0,25,6,3,2,4,15,1544632.95237598,9003058.72039865
1,23,6,0,1,4,11,1710055.6172995,6404927.2999835
0,24,0,1,0,7,8,2065700.80753711,4225918.73145251
0,38,3,1,2,0,6,1370934.27399588,5260539.64572576
1,36,6,3,1,4,14,2241507.37432259,8323202.10034519
0,20,2,3,2,0,7,1008071.60480829,4150760.19392455
0,13,0,3,1,6,10,2587797.92769383,6722175.93498425
0,39,2,1,2,1,6,1462325.78606516,4770073.63666
0,24,3,3,0,3,9,1468422.78459253,3356746.9751939
1,18,6,1,2,7,16,1899574.10309849,7904497.17620195
0,17,6,0,2,2,10,1944645.78833556,6865770.64125891
0,12,4,3,2,7,16,2730726.58690041,6467211.41399467
0,28,5,0,0,6,11,2186999.54185102,6634552.38539778
0,29,4,1,1,5,11,1844830.37423063,5112499.61702932
1,38,5,1,0,4,10,1827392.0015845,6038559.45774383
0,11,4,2,2,4,12,2755332.02687006,4769950.54273309
0,25,2,1,2,1,6,1481038.73592364,3550016.20472645
0,29,6,3,2,6,17,2717624.41572575,10957760.2977894
0,37,5,2,0,0,7,1658892.54762195,3321381.06057425
1,26,2,0,0,4,6,1370431.7562828,1763145.26798862
0,32,3,0,1,3,7,1905955.27172822,5000863.90987612
1,11,4,2,0,5,11,1825450.25833697,6518702.2352471
0,17,0,3,1,3,7,1539213.84876626,5030524.3486851
1,17,4,2,1,1,8,2066408.70432363,5688680.14189076
1,40,4,0,2,3,9,1672684.97862645,6408718.97387604
0,35,6,2,1,4,13,2129170.20345784,8672990.55102448
1,23,0,0,1,4,5,1661504.81949272,8351535.00207826
0,19,4,3,0,3,10,2473961.11305429,3631116.32705625
0,31,2,2,0,1,5,1293172.88680932,3655284.02369089
0,26,2,1,2,6,11,2658119.16646887,9897087.76710219
0,33,2,1,1,1,5,1444847.31422173,702856.487424437
1,34,1,0,2,6,9,1561769.07140904,6503793.36509906
1,23,5,3,1,5,14,2080315.58728108,4646835.73111147
0,19,0,2,2,4,8,2116497.83795898,6126422.35630825
0,20,4,0,0,2,6,1504726.62835378,2569177.47825147
0,29,0,1,1,6,8,2006125.62891249,6051974.9582274
1,36,1,1,2,7,11,2062981.88939715,6921070.60249717
1,33,2,2,2,6,12,1970416.58167396,5461500.61248931
1,39,6,1,2,1,10,1534262.64800235,2270788.40209187
0,31,2,2,0,4,8,1708277.94007641,3749438.64546697
0,38,1,1,1,4,7,1512683.34042113,5724704.4455079
1,10,1,1,1,3,6,1224716.61170427,3838388.59413996
1,24,2,2,0,5,9,1724372.69790701,7055079.0398916
0,27,5,2,1,3,11,2791749.49106251,4221175.69612896
0,29,3,2,2,2,9,1666579.23386992,3658667.6253673
0,12,2,2,0,4,8,1811905.36708854,3543509.17782923
1,18,2,0,0,2,4,1305346.78320069,4992185.82064426
1,11,6,1,1,7,15,2457543.05040479,7402168.92399041
1,39,6,2,1,5,14,2813997.29016997,4177570.64891172
1,19,4,0,2,7,13,2004999.77783095,6663240.17700562
0,34,3,3,2,4,12,1788454.35657406,9138391.34691615
1,19,6,3,1,0,10,2006622.49700563,5845899.37417788
0,37,1,2,2,6,11,1935326.67583618,4941791.43345743
0,28,4,0,0,1,5,1401696.51943587,4328638.13416896
0,31,6,2,2,4,14,2898988.57352406,8865582.86680248
0,10,5,1,1,4,11,2317010.44300997,3724329.84212282
0,36,2,1,2,1,6,1878349.83128992,5055469.785537
1,39,4,2,2,4,12,2233742.97045483,4365065.14989907
0,21,3,3,0,2,8,1901233.93697981,3147376.2452912
0,25,6,0,0,6,12,2413899.3731395,6104849.75359451
1,10,4,3,0,0,7,1829961.82813442,5398905.44829984
0,13,0,0,2,4,6,1798617.8735219,4694124.57036556
0,21,2,1,1,6,10,2206813.41688909,4167901.11427281
0,11,4,2,1,0,7,1509923.49725474,5948602.29654207
0,17,1,3,2,7,13,2349656.32335071,7001125.86446435
0,39,5,1,0,0,6,1126745.85957474,6954167.28102413
0,28,2,0,2,5,9,2082021.17802855,7931662.16982979
0,24,3,1,0,7,11,1824162.74810225,8556605.1367502
0,35,1,1,1,4,7,1711321.60331467,6235102.31494403
0,39,0,0,1,4,5,1635447.10496813,5365883.55829948
0,22,1,1,2,6,10,2183925.44030175,4662917.07303022
0,14,0,2,0,2,4,1441875.58334502,2068046.82650813
0,20,0,3,0,1,4,1544601.54442491,3393176.24927334
0,38,5,3,2,1,11,2084211.89068072,4929325.80866592
0,28,6,3,2,4,15,2605697.1856353,4979794.01372744
0,33,3,1,2,7,13,2355742.41536387,8489894.77514348
0,39,0,1,0,2,3,1247812.86962212,6205360.89285381
1,11,4,3,1,7,15,2010720.05277869,5420059.43285445
0,22,3,3,1,1,8,1603481.40221097,2714293.17612048
0,19,3,3,0,4,10,1659207.40708816,6301809.86887641
0,12,0,1,1,0,2,1042192.52331982,2824871.03158739
0,12,6,2,2,0,10,2497943.96319879,6420632.9533004
1,13,0,0,2,2,4,926344.282109104,3342957.06728278
0,10,2,3,1,4,10,1807430.45543327,8743555.24016539
1,36,0,2,2,7,11,2124153.89280226,6737480.45878833
1,15,0,1,1,3,5,1461187.45871778,8171317.12259693
0,22,4,1,2,1,8,1924469.10193932,3851766.67372627
0,24,2,3,0,3,8,1798617.81783723,5621690.81300504
0,17,0,1,1,3,5,1521083.33677212,6220706.19889736
1,27,5,1,2,0,8,1701209.91169022,4388087.01229967
0,24,5,2,2,4,13,2985990.1664271,8316867.00611432
0,23,5,0,1,7,13,2365628.11927191,2028752.25789713
0,31,3,0,2,1,6,1945152.7798659,3005767.36277618
0,31,3,0,1,2,6,1729268.01666408,3385317.08524532
0,28,6,1,2,1,10,1724102.05061555,6826467.1356441
0,12,0,1,0,3,4,1142368.89941793,5093270.83244096
0,34,0,2,1,6,9,2122887.03337074,7229055.06870498
0,29,3,0,1,3,7,1891995.67254965,4204098.34889445
0,31,2,2,2,6,12,2661552.42377384,5093198.18334698
0,30,6,1,0,5,12,2695055.87853729,5106813.03612864
1,19,0,1,2,3,6,1630798.46707869,4635705.28992968
0,17,0,1,0,2,3,1063511.3101402,4410953.52784903
0,31,1,1,0,0,2,1406825.73398327,3858716.94169433
1,32,6,1,1,2,10,2073680.35190562,4909438.61231379
0,13,2,3,2,0,7,1516059.02894723,5850506.4786314
0,22,1,1,1,7,10,2165501.57030146,3949114.65330413
0,19,6,3,1,0,10,1711359.36635326,2507033.29727364
0,37,0,2,0,3,5,1332634.54534819,7133610.49270105
0,24,2,1,2,4,9,1734800.12495567,5043323.11034403
1,19,1,3,0,1,5,1392148.6764071,7545650.7205411
1,33,5,1,1,0,7,1526254.58480487,2822433.86869189
0,17,6,0,0,6,12,2108552.24289863,6612719.55881296
1,21,6,3,2,3,14,2141278.332692,7899749.51207001
0,18,5,0,0,7,12,2502449.18194298,6347617.57725256
0,18,5,3,2,2,12,2438186.32654067,8825967.11041873
0,38,0,0,0,4,4,1442336.21181116,4922243.65202206
0,29,2,3,0,7,12,1840512.2698484,4215187.22617636
0,16,3,0,1,4,8,1591763.18159565,3296206.73642144
0,39,5,0,0,5,10,1866370.73853658,6208388.27541015
1,34,5,3,1,6,15,2265806.81077098,5727077.71017726
0,36,0,0,1,3,4,1147874.31372329,6732665.9112688
0,25,3,2,0,3,8,1544270.25424928,4081450.18129493
1,38,3,2,2,6,13,2492590.43017649,4290617.8253035
1,32,0,2,1,6,9,1989246.39351924,7537953.95990017
1,15,1,2,2,5,10,1905831.30762983,6029923.25375521
0,21,2,2,0,7,11,2658480.91381613,4119398.38824361
1,23,0,1,2,6,9,1683977.19074477,5137927.14983636
0,11,2,3,1,1,7,1326718.09981848,4483950.43208004
0,22,3,1,2,7,13,2523810.69690101,7375959.45635782
0,36,5,0,0,2,7,1473187.09530735,4150744.56926021
1,40,2,2,2,6,12,2126716.82989657,5929426.66088189
1,12,1,3,0,4,8,1645903.5654396,4345914.63191
0,27,1,3,2,2,8,2122767.50374283,6169597.41977901
0,17,5,1,0,7,13,2426197.63093429,5279247.08631361
1,12,1,1,2,2,6,1897913.60405958,3404349.94919513
0,12,6,1,1,7,15,2472455.61482907,3990400.83390728
0,17,4,1,0,7,12,2125111.70176297,4954061.43097582
1,35,4,0,0,4,8,1926256.19260616,6118530.53753107
1,13,5,0,1,2,8,1938300.13685822,4730081.80762153
0,19,3,1,0,2,6,1341633.5906272,6379987.19859681
0,10,4,2,0,0,6,1724181.19865364,4655261.71515723
1,33,6,2,1,2,11,1979032.85735949,6455405.7898041
0,32,2,2,2,5,11,1988786.03120104,5327539.48616761
1,10,2,3,0,7,12,2071299.76315699,5947574.71346258
0,18,4,2,2,2,10,1795708.94360413,8323512.996046
0,37,2,1,0,0,3,1322139.79656224,5791579.941514
0,17,2,2,1,5,10,2084447.72912662,4390997.74222554
0,21,1,0,2,0,3,1408256.68034537,4016007.67198089
0,11,1,2,2,6,11,2070427.87118545,4578366.68844333
1,10,5,0,2,0,7,1375075.80840984,4260281.2803224
0,24,3,1,1,0,5,1712225.24392619,5541531.09497807
0,22,2,3,2,7,14,1798608.29300787,7462469.4359148
0,32,3,1,1,7,12,2079342.08945641,8647444.87868055
1,13,1,0,0,2,3,1267299.48405244,4457318.30310045
0,33,2,3,0,6,11,2238671.9916358,5311052.82439024
0,28,3,2,2,4,11,2340336.1134821,9441073.25837933
0,28,2,0,1,5,8,1672596.25457579,4579996.35530928
0,23,0,3,0,3,6,1494121.63666908,5240306.95889996
0,10,5,0,2,0,7,1412499.61446917,3932722.47018629
1,21,2,3,0,4,9,1328110.3771481,5540813.64166545
0,19,2,2,0,6,10,1680273.89728685,5999050.69715688
0,10,2,1,0,1,4,1290984.11925559,2524501.40257595
1,10,0,2,1,7,10,1723429.16119048,6442369.54779903
0,30,6,0,1,1,8,1688496.7691162,5726971.12899008
0,38,3,0,0,5,8,1586987.72255693,8062926.30118465
0,39,0,0,2,6,8,2003537.54117224,5818686.46030967
0,38,5,1,1,1,8,1852873.1930752,4514985.18778493
0,21,2,3,1,0,6,1760776.39149242,6596315.41904234
0,35,4,0,1,0,5,1467200.87995608,7738105.56739284
0,35,3,3,1,3,10,2346269.80730166,5595446.39075672
1,34,4,1,0,1,6,1489911.85408448,6615434.05588381
0,10,0,3,2,7,12,1975291.38187467,6285212.82401249
0,35,2,1,1,2,6,1268596.35095548,5070201.25546549
1,28,6,1,2,3,12,2490486.87448954,6221906.38851262
0,17,1,2,0,6,9,1996852.70889138,7093926.60939819
0,40,5,0,1,3,9,1785436.16582274,4493691.74984254
0,25,2,0,1,5,8,1717398.71290261,6389232.07823163
0,37,0,1,0,2,3,1112685.57120151,3671203.92518054
0,39,0,3,2,1,6,1264783.48531943,6712720.77884475
0,33,4,2,0,6,12,2638168.65646158,228788.591001194
1,39,5,0,2,3,10,2094940.16569847,5155476.25726932
0,16,4,2,0,4,10,2181924.9283823,4633390.09192718
1,32,2,2,1,0,5,1850176.03185511,4573003.93880162
0,17,4,1,0,3,8,2147801.5315094,5966331.42381819
1,34,2,0,2,7,11,2055728.94049769,7364106.6451236
1,10,6,1,0,7,14,1500053.40061545,7136939.57839313
0,26,1,1,1,3,6,1877150.2799934,3795861.52818243
0,28,2,1,0,4,7,2075476.76900416,6703341.19684073
1,14,2,2,2,3,9,1512813.6747969,6741864.57372818
0,39,1,2,0,3,6,1643861.81887331,7881820.81491588
1,15,3,3,2,7,15,2807487.50337426,6783895.11975875
1,23,6,1,0,2,9,1781422.61910465,7893483.47661522
0,33,3,3,0,4,10,2307215.48081147,7544405.449022
0,10,0,1,0,0,1,776508.906315645,3526931.00867216
0,28,2,2,2,6,12,2384706.23719979,9771533.3225467
0,26,5,1,0,3,9,1976396.62356839,4488364.19457356
0,10,6,0,2,7,15,2373378.29871942,9392474.5745108
0,19,3,1,1,1,6,1604904.54629074,4319245.63980837
1,27,5,2,0,6,13,2951259.82930379,8701297.82630378
1,26,6,1,1,6,14,2627112.49798154,8092822.95577996
0,13,0,1,2,4,7,1825210.60817336,8550046.76472038
1,40,6,1,0,2,9,1866856.94676648,6759098.49740167
0,37,0,2,0,1,3,1466956.49804795,6897613.25114418
1,40,3,3,0,7,13,2313279.35889364,8040455.48345686
0,16,2,2,0,7,11,2372304.63852428,6433957.16608736
1,26,5,2,0,2,9,1562445.46695853,7625540.11794243
0,33,6,1,0,5,12,2601903.40383687,8637355.26844555
0,13,5,2,1,1,9,2042078.29797899,8236794.75930316
0,37,4,0,0,2,6,1909342.56873744,3523706.18475658
0,18,2,2,1,0,5,1669018.66989705,7050590.06928088
0,39,0,3,2,7,12,2187700.17865178,7125919.88871534
0,15,1,0,2,6,9,2136352.0453268,6097647.02540153
1,37,3,0,0,0,3,1769050.34119845,2731448.12873936
0,20,3,1,0,5,9,2109408.47818822,5227203.60229874
1,12,3,3,1,0,7,1193795.72402493,3338925.64540424
0,20,6,1,2,3,12,1749544.23561826,8570890.61648066
1,20,3,3,0,5,11,2761692.11664964,8581997.57653388
1,20,4,1,2,6,13,2234907.29944371,8825426.25957437
0,36,2,1,2,1,6,1512086.03609916,5885495.00713303
1,17,6,3,2,2,13,2275331.59951773,7604041.09704677
0,40,1,1,2,7,11,2064300.91432269,6748786.04504271
0,31,6,2,0,0,8,1575727.89133196,2519674.99324095
0,16,5,2,0,7,14,1780401.42280566,9946069.51199878
1,21,3,2,1,1,7,1609590.8870149,5288681.33262936
0,27,6,0,1,2,9,2065565.83217483,2829505.46610702
0,19,3,2,1,0,6,1953006.63607973,3419268.9210382
0,27,6,2,1,3,12,2549926.31282306,5909193.93272783
0,20,4,2,1,4,11,1849235.37112406,4796998.45274081
0,35,1,0,1,0,2,1367502.95927959,2570399.71096476
0,37,3,1,2,2,8,1742575.90302586,5216625.43103452
0,35,3,1,1,4,9,1547866.40160104,5740480.31626665
0,15,2,0,0,1,3,898549.752017571,4762411.3523822
1,28,3,0,2,6,11,1789390.57927389,3274710.79132274
1,37,4,3,1,6,14,2252545.97468187,5572999.67319423
1,18,4,1,0,3,8,1147669.07261307,2952995.75965912
0,24,1,1,2,1,5,1526935.80199289,4635340.02626619
1,11,3,0,2,5,10,2348614.98251907,5659033.08804214
1,39,6,3,2,4,15,2574445.23502245,5739137.41514616
0,37,0,2,1,2,5,1302403.30228744,5122641.56721626
0,31,6,1,2,0,9,1420256.07825693,6053289.18429007
0,18,4,3,0,6,13,2626140.77277005,5786737.5214515
0,31,4,3,2,0,9,1815845.67605376,4766300.89744765
1,21,2,3,0,5,10,2177681.03771154,4700001.99881432
0,10,1,0,2,4,7,1703978.68663182,3915882.633767
1,24,6,2,1,6,15,2824923.53423365,7962174.03385614
0,39,6,0,1,2,9,1790811.56695419,5549184.78017985
0,26,1,0,0,5,6,1498931.0396895,4671073.2663512
1,30,5,0,0,2,7,1778921.09156057,5168469.4848363
1,35,6,0,2,2,10,1853644.94628922,9371074.00671946
1,35,2,2,1,7,12,1915301.50912464,6064346.52040051
1,34,3,2,0,1,6,1981550.39349553,4699546.85677391
0,20,2,0,2,4,8,2192071.33011761,5899508.17272272
0,13,0,2,1,3,6,1469933.17126919,8279092.19574032
0,39,6,1,2,1,10,2144795.72009626,8378476.24705221
0,11,5,1,0,2,8,1490599.96770219,6183720.95962829
0,25,4,1,1,7,13,1925181.06590898,4040572.60062369
1,36,1,2,1,5,9,1520463.19352783,2990388.27384577
0,11,4,1,0,7,12,1126833.20489039,3797608.25301565
1,34,3,3,2,4,12,1780847.51587007,6839655.14644572
0,12,6,2,2,0,10,1990723.64233812,8723544.50757726
1,40,4,0,0,6,10,2077413.48837006,5019730.36991482
1,16,0,1,2,4,7,1643266.71647349,5586920.30716971
1,33,3,1,0,7,11,1454137.58829878,9475520.98504628
1,27,5,3,1,5,14,2215585.25898472,8566170.5897765
0,17,6,1,2,1,10,2002309.0870766,3285432.2023711
1,19,6,3,0,7,16,2796387.32205689,6726823.0070569
0,10,4,3,2,2,11,2090505.47565279,7922392.64946938
0,17,2,1,2,6,11,2341143.80695991,6279997.93233233
1,29,6,3,1,2,12,2537237.16263262,6469707.60801035
0,25,6,1,1,1,9,1570322.11448478,9211877.11834924
0,24,3,3,2,7,15,2540247.31534161,6580270.00834647
0,13,5,3,2,3,13,2486622.18002985,6695090.28940772
1,27,0,2,1,7,10,2383772.03154845,7998379.48588016
1,26,6,1,2,2,11,2411746.42064059,5658655.29367029
0,15,2,0,2,0,4,1323094.35812655,4865111.59967986
0,33,2,1,2,4,9,1961983.08403205,9331632.35341318
0,35,2,0,2,1,5,1414230.27589997,2878158.97159443
0,17,3,1,0,6,10,1087980.67654003,6962170.45510972
1,25,2,0,2,1,5,1383064.83139842,5537995.69163637
0,15,6,0,2,7,15,2615106.93854344,4394920.62503781
0,26,3,3,1,2,9,2353844.29974121,3818095.81974017
0,37,4,0,0,4,8,1601122.90675209,7250611.79143542
0,33,5,1,2,7,15,2082390.15322084,5686775.07050276
1,20,5,0,2,5,12,2059000.33286997,6279781.35993653
0,31,6,1,1,4,12,2546588.8220234,6917423.10974229
0,24,5,2,2,2,11,2180444.48776468,5390914.94996177
1,25,6,2,1,4,13,2233035.7760202,8572120.28895499
0,38,6,2,0,3,11,1820927.55700542,9477004.77800686
0,28,6,1,1,5,13,2060463.97385737,8201340.36166687
0,28,4,3,2,5,14,2086327.60779831,8066283.27713821
0,40,5,1,2,3,11,1475305.11312374,5456910.50049983
0,39,0,2,0,1,3,1443012.33531607,3185590.76370886
0,39,1,1,2,3,7,1777301.91028524,9000106.42599335
0,25,2,0,0,0,2,1151259.03892807,4078286.7306495
0,39,2,1,1,6,10,1983339.03300871,3498999.62898005
0,27,1,2,0,6,9,2130273.73493742,5233866.3378167
0,21,0,1,1,6,8,1234564.70142854,8962151.40910557
0,23,0,3,0,1,4,849476.065838188,3882229.76079193
0,30,5,2,2,4,13,2218475.62644033,6379806.33779706
0,11,5,0,1,1,7,1869033.11604899,4647987.16258102
0,32,5,3,1,0,9,2203273.05535036,6657547.99057659
0,10,6,3,1,4,14,1979598.26626496,8410453.32697391
1,23,5,2,0,1,8,1764056.13066068,3676608.78596605
0,38,6,3,1,6,16,2564699.75080287,8020685.88503671
0,31,5,2,0,2,9,1632612.36512389,5385521.39445614
1,39,5,1,0,3,9,2171812.44037903,3690354.28650618
1,14,1,3,2,5,11,2284089.89398293,7925126.50125153
0,24,0,0,2,2,4,1271130.62766542,2255746.10190422
0,17,0,2,2,1,5,1214177.68263293,2377982.04166762
0,13,3,3,2,1,9,1933368.7459807,7048740.00699456
1,17,1,3,2,7,13,1796702.25773375,3735086.16486342
0,37,6,3,1,6,16,2415093.08309061,9838158.10525094
0,11,5,3,1,0,9,1977356.87732332,9802126.17684378
0,24,0,2,0,7,9,2211997.71053423,5459023.82444865
0,20,2,2,1,1,6,1559372.65827917,4095540.7348001
0,33,3,1,2,0,6,1817541.66676933,4394892.62865616
0,36,1,1,2,6,10,1782743.39567993,9507253.11308988
0,10,6,1,0,3,10,1971452.20619945,4291208.47872676
0,34,0,3,1,5,9,1299880.65975375,5634693.80380502
1,16,4,0,0,4,8,1454294.94691201,3795607.3574806
0,40,3,1,1,3,8,2048684.68052254,7523981.70096546
1,24,2,3,0,6,11,1945454.6367481,5217481.82870761
0,34,0,1,0,4,5,1395358.00170697,4270229.06813764
0,31,4,0,0,3,7,1319689.29687688,4040535.79982987
0,27,3,3,1,4,11,2319041.39637252,4087489.5967259
0,14,1,2,2,5,10,1618432.87264274,5712814.52153972
0,30,2,3,2,4,11,2202944.2658892,4175131.36785163
1,20,1,1,2,6,10,1771329.75001436,3803167.95484547
0,17,0,1,2,3,6,1235125.88009217,6032151.52665274
0,34,4,0,0,7,11,2364584.13693063,3980851.79622365
0,36,5,0,2,6,13,2383815.71959991,2561449.61466861
1,13,6,2,1,2,11,2330233.36619668,8758152.70757432
0,31,6,0,0,1,7,1663849.70598922,4834193.34836171
0,39,2,2,0,3,7,2003411.92324163,7431691.4509719
0,35,6,3,2,6,17,2895832.2169363,10361925.3735149
0,15,5,0,0,7,12,2286392.15315009,9530469.82562857
1,19,6,1,0,1,8,1991613.00522614,5156459.85265226
1,23,3,3,1,3,10,1859113.9224339,8251203.23896207
0,34,4,0,2,3,9,2112954.49814387,6493999.19852262
0,18,1,0,0,3,4,1713955.09619333,3977030.10007276
0,11,6,0,0,2,8,1721685.26183428,6114409.36651692
0,27,4,1,0,4,9,2114017.50527921,6442426.69183323
0,19,6,3,0,2,11,2000508.79686466,4348476.59634378
0,38,4,1,1,6,12,2342865.88417398,8094594.57631604
0,25,0,0,2,4,6,1400720.27256649,7830993.44011734
0,15,1,2,2,2,7,1417873.25593443,5595046.6298002
1,27,0,3,2,2,7,2086892.00388982,7385747.84977861
1,38,6,2,0,0,8,1684592.04991467,5187189.66037998
0,20,1,3,1,3,8,1570653.92167474,2924581.02760944
0,35,5,1,0,0,6,2099409.28490409,4936766.95757899
1,26,6,1,2,0,9,1949829.25547784,6573673.75236518
0,17,3,0,2,4,9,1712466.72271794,5898753.1836842
0,30,6,3,2,2,13,2043694.03920646,6578375.31680923
0,18,3,0,1,6,10,2180063.98799568,6755285.77045511
0,16,6,2,1,0,9,2130385.23933871,4745314.75259279
1,33,1,3,1,2,7,1752713.83154208,6921799.55601466
1,14,6,0,2,4,12,2180988.62514578,7466469.18294153
0,28,4,1,2,0,7,1547418.89276969,5463140.26618224
0,39,6,2,0,0,8,1870184.16736443,4694361.42642319
0,32,3,1,0,6,10,2632166.82400407,3573509.98423285
0,38,0,3,2,7,12,3075843.92823212,4305349.65549232
0,37,2,3,2,1,8,1844836.12445384,4392575.46223303
1,17,6,0,0,5,11,2145094.35884506,7229393.55569236
0,40,3,1,1,2,7,1928497.57641415,1980536.4010102
0,35,5,3,0,5,13,2077905.64559335,8708365.78862024
0,30,5,0,1,6,12,2617836.79046479,5557405.63897003
0,13,3,3,1,6,13,2164814.01691239,3815040.68334538
0,18,0,3,1,6,10,1717407.30796425,4159180.77762201
0,27,5,2,1,7,15,2742581.60895628,7206232.52131822
1,36,3,1,0,7,11,2629470.31415924,3258274.54933946
1,35,6,2,2,0,10,1921454.02459587,7338940.93456909
1,37,2,1,2,2,7,1579964.85633831,6299164.32519594
1,36,1,0,2,2,5,1540353.92178282,5502309.12441098
1,21,5,3,0,3,11,1587251.22889638,10606647.726743
0,32,6,2,1,7,16,3460869.76926862,8802487.33143776
1,11,4,1,0,1,6,1654975.55439248,5003485.20101787
0,14,6,0,1,3,10,2089008.29644455,6657334.2147076
0,18,5,2,2,2,11,2267375.90202568,6481891.87527457
0,16,4,1,0,3,8,1922135.30451406,4394935.47500326
0,34,1,2,0,5,8,1784338.85879015,6773578.94055935
0,18,3,1,2,3,9,1778679.74066647,4921964.80065594
0,23,5,1,0,4,10,2056900.87274625,5428322.85585573
0,38,2,3,1,2,8,2018903.37132058,6787690.63461723
0,24,6,3,0,6,15,2718602.11633425,5598279.06434253
1,35,3,3,0,7,13,2972140.34508854,4648327.57163866
1,16,6,1,0,2,9,1329791.43218233,5663472.91395062
0,23,6,3,0,4,13,2983241.68623084,11203386.143579
0,16,5,3,2,4,14,1993547.0645675,8171398.99584152
1,39,2,2,1,6,11,1806978.8572987,5576828.13368888
0,40,1,1,1,4,7,1729308.75390563,4040856.73280282
0,29,4,2,1,6,13,3155382.6268138,5351750.66401405
0,40,0,1,0,7,8,1524917.13746403,2187177.73928825
0,21,3,2,1,5,11,2643145.15562356,6903901.26366173
0,13,2,2,0,3,7,1797013.88942203,4987944.27660169
1,11,4,0,2,7,13,2935011.2292908,5543548.7738927
1,13,1,1,0,2,4,1495532.16584941,2466707.12974176
1,35,2,3,0,0,5,1871867.45204128,3849328.98244797
1,15,6,2,2,7,17,2992200.72429952,6655933.48672482
0,31,6,2,0,4,12,1815361.01165803,9296770.92506891
1,34,5,3,1,2,11,2048979.03862392,9180106.61670098
0,27,3,0,2,6,11,1610755.84777298,7616211.19928227
0,21,5,1,0,0,6,1505590.07237901,4599702.77376051
0,21,0,1,1,4,6,2005786.49248803,7332448.50707822
1,23,2,0,2,6,10,2073683.98799248,5403390.97578598
1,32,5,2,2,2,11,1795680.86839146,11050380.4184452
0,25,5,2,1,5,13,2304308.89714275,7533784.93800171
0,30,6,3,2,6,17,2542525.7481173,7438720.91525671
1,34,1,3,1,0,5,1304898.97177219,5133974.47613757
1,31,2,3,0,5,10,1591531.31268868,6127220.90539565
1,13,1,2,2,7,12,2384664.78266253,4419902.52455923
0,28,1,3,2,0,6,1661272.25645658,3963468.6451495
0,12,4,1,2,4,11,2650102.18046054,3581972.57601803
1,40,1,2,2,3,8,2078438.78312525,6443963.92992357
0,33,0,3,2,1,6,1780412.60620198,2426569.47481055
1,35,2,3,2,7,14,2194700.61182073,6621758.3154385
0,26,6,2,0,1,9,2162335.30573991,7643083.91674903
1,18,6,2,0,5,13,1701369.92641104,8767380.71508939
0,13,2,0,2,4,8,1803513.07159844,6830510.6139883
1,25,5,0,0,0,5,1676865.79674762,3754581.9731291
0,17,3,0,2,1,6,1464842.17914329,1710985.68197674
1,12,5,0,1,7,13,2417767.03130601,9394070.205393
1,19,3,2,1,5,11,2453580.68895567,4071609.00456721
1,12,3,3,2,2,10,2335888.91665581,10170522.9891524
1,10,5,0,1,0,6,1510912.08938324,2446148.07577545
1,30,6,0,0,0,6,1470109.12056272,1051900.68315289
0,18,5,2,0,6,13,2404895.28021303,6823463.46187625
0,21,6,0,0,3,9,2074208.57504356,3605035.25897307
0,18,6,2,1,5,14,2323197.78661648,5962251.20607682
0,14,1,1,1,0,3,1274529.05675728,3779960.23139528
0,37,5,1,1,3,10,1643207.40522463,7292522.71885048
0,33,5,0,1,2,8,1974764.88231626,8639988.60717229
0,24,5,2,2,6,15,2508852.78392766,5006895.31478592
0,34,5,2,0,2,9,1831099.09827123,6012168.91838462
0,36,0,3,2,1,6,1682547.22906068,5420971.61803744
1,28,1,3,0,6,10,1602966.70430534,2285098.95248707
0,36,6,3,0,4,13,2012179.98221161,10902085.8953994
0,13,1,0,1,0,2,1251291.10280856,2092570.56251658
0,28,2,0,1,6,9,1660057.71077752,5282926.23485941
0,22,5,2,0,6,13,2824074.83191538,5508944.04244459
0,19,2,2,1,5,10,1826052.41637708,5217133.95183568
1,10,2,3,0,3,8,1876176.54261148,4054879.90594009
1,11,3,0,1,7,11,2228661.33210197,7282534.8305576
0,16,5,1,2,4,12,1652173.77436524,3130016.82847764
0,26,2,0,2,3,7,2103646.68748092,3860365.25841174
0,22,6,0,1,0,7,2282061.01490844,7271249.7882193
1,32,3,3,2,0,8,1615568.61069064,5535546.2452477
0,25,2,2,1,6,11,1966065.02996558,6495614.80527376
0,22,3,0,1,5,9,1601560.49509274,2613900.54213031
0,36,6,2,0,3,11,2472363.44992237,5093343.2005178
1,11,0,2,1,5,8,1747554.08822323,5831961.06663404
0,27,3,3,0,7,13,3167731.570112,4391601.36898168
0,12,0,3,1,3,7,1687759.83739327,6897349.11088525
1,25,0,3,0,1,4,1182502.66945197,5177719.11769339
0,35,3,0,2,3,8,1338825.54949215,4643397.06921464
0,34,5,1,0,1,7,1279854.74347762,4114467.23849997
0,12,0,3,2,5,10,2142605.74100589,2841450.06194803
1,34,5,1,1,3,10,2147879.82848616,9643720.95929934
1,30,2,3,1,2,8,1691607.68959702,5017292.75292679
0,39,5,3,2,4,14,2111319.62894489,6632366.59275237
1,10,3,2,0,0,5,2264932.08267554,2549428.5702799
0,35,4,1,2,4,11,2270636.46255915,6275243.28568471
0,14,0,2,0,7,9,1233567.97223867,6588759.18306848
0,33,6,3,2,1,12,2239646.40158208,9718932.20291617
0,26,1,3,0,2,6,1771292.64975089,7197189.7472815
0,29,0,3,2,5,10,1846898.2472002,6829426.21412103
1,11,4,3,2,0,9,1555634.37531899,5876257.56405268
0,22,2,3,0,4,9,2393416.42940331,4028886.52742229
0,10,5,3,2,0,10,2055162.3429119,2822071.99869259
1,23,1,1,0,1,3,922812.597607952,3022727.33589227
0,35,4,0,1,5,10,2129119.5674711,3488140.64227728
0,13,0,2,2,5,9,1599625.71539417,7266419.76202043
0,12,1,0,1,5,7,1638422.40450915,5104171.41905806
0,24,0,0,0,4,4,1237950.62670427,2673438.85101175
0,29,0,3,1,7,11,1598604.60929838,4968288.92959356
1,39,6,0,1,4,11,1876361.13613847,5678979.4380716
0,37,2,2,1,2,7,1338505.80612145,3541255.45083848
0,19,5,3,1,7,16,1975670.17219518,13339004.9993035
0,20,5,2,2,1,10,2111181.30268811,7388188.65180284
1,23,0,1,2,7,10,1454072.57136739,3650342.39836169
0,15,2,3,0,6,11,1532908.81562503,4250984.87777338
1,25,6,3,0,5,14,1905051.98982077,4732928.44047455
0,38,4,0,2,2,8,1751456.66555556,6768655.31949579
1,35,1,0,2,0,3,1289187.5016808,3857740.70097907
0,17,3,3,2,2,10,2390332.73655537,7044784.13423946
0,26,1,2,1,3,7,1799710.17952866,4562467.02412546
0,12,4,2,1,6,13,1814893.74676861,4921150.00425185
0,15,2,0,2,5,9,1581237.50904209,4788056.37200254
0,22,4,0,0,2,6,1341476.78360524,5234663.95107737
0,35,2,1,2,2,7,1266776.11565816,5817627.15434153
1,11,6,2,1,3,12,1766969.53934158,8933416.20050953
0,15,5,1,2,0,8,2196255.79389091,5879014.50603136
0,32,2,2,0,5,9,1594110.18150077,9231867.48234749
1,20,6,2,0,3,11,1865522.47631814,5926743.99264714
0,40,5,2,0,5,12,2247723.54384516,6252509.26184043
1,14,0,1,1,1,3,1302911.05189064,3036863.22204127
0,13,6,1,1,3,11,1920022.83650197,9431739.97785096
1,29,6,3,1,6,16,2442370.8316679,10871364.4439022
0,28,5,3,0,0,8,1796873.68657245,3417617.11099649
0,27,3,3,2,5,13,2167633.03868494,10379728.2752368
0,37,2,1,2,5,10,2344773.28406679,5503216.47870724
0,26,6,0,2,2,10,1763198.13044053,8562557.63597232
0,16,4,3,1,2,10,1735870.45439718,6917870.65518476
1,11,4,3,1,2,10,1327794.43954017,3867171.73992011
0,25,3,1,2,7,13,2051247.20624047,7302672.13741623
0,38,1,3,1,0,5,1956918.30153868,4155290.44257086
0,23,6,3,1,2,12,2347133.85774142,5476036.40826986
0,31,4,1,2,7,14,1673231.17236136,6298361.60219097
1,38,4,2,1,7,14,2404568.92119853,4854709.14837421
1,26,5,1,1,2,9,1297296.24109522,8238096.94683088
0,22,5,1,2,2,10,1672614.39367777,5289027.97368499
0,18,4,1,0,4,9,1930651.03076537,5681104.60828832
0,17,0,2,2,6,10,1664654.21548778,5402610.23935756
0,39,3,0,1,2,6,1552141.96472468,5933910.70153722
0,14,0,2,0,1,3,1561126.24191581,3142323.88918691
0,39,5,2,1,4,12,2390008.08536062,7585829.85578674
1,25,6,1,2,4,13,2139928.58291225,7212768.36608764
1,32,1,2,2,5,10,2292293.52176047,6365055.2292706
1,33,2,1,1,6,10,1847961.15591508,5957472.35082121
0,29,0,2,2,1,5,1290258.20954756,1857193.50691056
0,30,4,2,2,2,10,1726014.29135023,8400883.97850439
1,17,6,3,0,1,10,1526694.78147859,5672786.44783097
0,20,6,3,0,4,13,3025396.07883445,6636568.09717817
0,25,5,0,0,7,12,2367502.07535699,5638581.61362616
0,39,0,1,2,3,6,1112072.12073112,3653732.14231715
0,24,3,2,0,0,5,1487700.49422658,3748449.3858756
0,19,5,3,1,7,16,3361937.18940993,10080612.3087551
0,39,3,3,2,0,8,1932889.45499677,2305278.60426592
0,40,2,2,0,2,6,1621981.76555355,7883050.21938026
0,31,5,2,2,1,10,2683840.62319509,7543054.3437039
0,18,5,2,2,3,12,1878769.07088419,9075792.9923649
0,34,0,3,2,6,11,1931614.13137804,8169084.64385569
1,25,1,1,0,5,7,1576722.25744964,4489712.89117253
0,35,5,1,0,3,9,1676894.39275226,8829221.38304364
0,11,3,0,1,4,8,1347542.36812051,7340260.07087697
1,38,3,1,1,7,12,2214809.0682177,6382549.86273079
1,25,2,2,0,4,8,2046560.18876377,4152250.54315623
1,37,4,1,1,0,6,1980128.15637768,4276901.1156457
0,25,1,3,1,0,5,1675381.12519838,2503313.5967545
0,20,3,1,0,2,6,1685167.77872707,707793.727686578
0,16,1,3,1,3,8,1850251.61563096,4773283.04991647
1,28,3,0,0,2,5,1806351.35235817,3698898.63300662
0,10,3,2,2,4,11,2201471.52557733,8024250.04501721
0,13,1,3,1,6,11,2689191.5019499,7191279.06797941
0,19,3,2,1,7,13,1649279.12090324,8232707.49621744
0,36,6,0,0,6,12,2016590.42757619,5419957.96230372
0,32,6,1,1,1,9,1750876.26282909,7106221.85331423
0,26,0,2,1,2,5,1241417.43474358,4097888.82108759
1,13,4,2,1,5,12,2279803.44265842,7249271.70087302
0,15,4,3,0,5,12,2281760.61534819,8286238.69945382
0,13,4,1,0,5,10,1891096.64279899,5213977.14681745
0,33,4,3,2,4,13,2779526.48441945,4623016.96501939
0,24,2,2,2,7,13,2387918.93386857,5714045.24084298
1,24,6,1,0,6,13,1931701.68396572,4521652.17751344
1,16,1,2,1,1,5,1202645.82690592,4011866.54776666
1,17,4,2,2,3,11,1994499.02212466,7790288.70238542
1,30,4,0,0,3,7,2130981.32021821,4512929.09405814
0,22,3,0,0,6,9,2063981.77979396,3916303.29719933
1,15,4,1,1,4,10,1740036.73501316,4068219.35921465
0,34,1,2,2,5,10,1893286.42844125,7597964.27958739
1,23,3,3,1,0,7,1612233.58140162,2969488.90018666
1,28,5,0,2,5,12,2753178.59024749,8228711.58487321
0,25,1,0,1,7,9,2013569.35829861,3671750.89929129
0,14,0,2,0,1,3,1219794.09046553,4449540.87168773
0,16,5,3,1,2,11,2572007.17851231,5137829.02274281
0,23,1,3,0,5,9,1982868.34561161,8860642.26022286
0,16,5,0,0,7,12,2094300.14302553,6832624.63686498
0,36,4,1,1,2,8,1550180.4763748,4077620.1965949
0,18,5,0,0,1,6,1615057.1680278,3932285.64549519
1,38,5,0,2,6,13,2984056.03342749,3010138.12415017
0,27,5,1,0,1,7,1407855.91855078,7892715.67021122
0,21,0,1,1,1,3,1308923.75823273,3909094.20599604
0,12,0,3,1,0,4,1042221.36921468,4644483.31729676
0,22,3,1,1,5,10,1987891.41613127,5936423.45722914
1,29,5,0,0,4,9,2218653.32068932,1328723.36225748
0,37,1,1,1,3,6,1638687.07962244,409040.981486242
0,37,1,3,1,0,5,1308316.284959,4746924.64737162
1,24,1,3,1,1,6,1405690.8782347,4398688.68133687
0,16,0,3,2,7,12,2409747.21645216,8293169.91359047
0,16,5,0,0,3,8,1913127.99206944,4694695.88138293
1,14,4,1,2,4,11,2345809.88895848,8646212.11640892
0,29,6,2,0,6,14,2729279.31796771,9493934.03233869
0,29,1,3,0,1,5,1538862.6689316,3654379.72453985
0,11,3,3,2,5,13,1826109.47444768,7713470.38917462
1,24,5,1,1,4,11,1763496.32269738,8530622.0282538
1,27,5,0,2,6,13,1938440.10864415,8657585.91929827
