"sex","age","Computer","TV","Cellphone","Software","Frequency3","Monetary3","Monetary60"
0,11,3,0,2,7,12,2005249.54015982,8471040.00646287
0,21,2,3,2,0,7,1435587.20886415,2920197.69754586
0,39,5,2,2,2,11,1616419.44636605,8879458.56473956
1,34,0,0,1,2,3,959813.589429505,5838364.32182597
0,34,2,3,1,1,7,2277999.04381461,1744288.67515001
0,14,0,3,1,5,9,2057668.0818539,4433342.22105179
0,21,1,0,2,7,10,2022060.50920929,6461779.79280872
1,28,6,0,2,4,12,2181542.7326535,9401597.83731326
0,15,5,1,0,2,8,2248205.84882543,10231754.8308338
0,38,0,0,2,4,6,2010738.59791034,5204043.99111684
1,15,1,0,2,7,10,1602045.14159143,8040556.38982296
0,17,2,0,1,6,9,1773951.09770425,3007026.78014424
1,12,5,1,1,6,13,1717205.86207714,7798475.61298515
1,33,2,3,0,1,6,1256316.99953031,5033687.93672615
1,18,2,1,2,2,7,2148819.49159249,3144087.00160865
0,36,0,0,2,5,7,2144615.77575436,3284452.08827516
1,22,3,3,1,4,11,2390941.16358869,4946138.42623706
1,29,1,1,0,1,3,1045246.62466261,5791066.47118177
0,12,2,0,1,5,8,1424077.03869676,8251232.28122403
0,12,3,0,1,5,9,1972866.77387346,5515062.50759913
1,21,5,0,1,0,6,1885636.41300439,5729916.43114765
0,18,1,2,0,1,4,1161270.66447012,4430723.11454553
1,23,1,0,2,2,5,1441907.38343885,2893831.04772894
0,27,1,1,2,0,4,1747703.11345502,4712757.46121839
0,35,3,3,0,7,13,2820407.77049217,5956484.54144851
1,20,3,3,2,4,12,1536235.79170422,4480518.9767335
1,24,5,3,1,2,11,2329214.55800273,5487186.21986827
1,27,3,0,1,1,5,1103020.34087071,1852498.36424921
0,24,6,1,2,2,11,2198676.90803357,3455679.28059421
0,26,2,2,0,1,5,1596113.57167561,3811003.4560018
0,19,6,2,1,7,16,2658807.95430773,7207818.26921529
1,36,4,0,1,2,7,1665331.68006244,4198225.67233913
0,35,2,0,2,4,8,1593719.37678734,3255527.27015109
0,28,4,2,0,5,11,2080681.94723711,4049195.26851671
1,21,1,1,2,6,10,1736970.94483264,6629530.04314664
1,39,1,1,0,7,9,2445858.55968533,6728417.88784453
0,18,5,2,2,4,13,1886510.76624603,12003000.9693877
1,22,3,0,0,7,10,1911039.39130301,5222719.88327962
1,11,6,1,0,6,13,2110878.09114133,6969444.48265605
0,34,0,1,1,2,4,1383883.49109567,2274434.343439
1,21,1,1,0,6,8,1500473.22606927,7734046.67647959
0,28,0,0,2,5,7,2414444.66462233,5727326.41836137
0,12,2,0,1,0,3,982401.333467851,5063049.73986419
1,39,2,1,0,3,6,1723228.95320779,4133713.22341181
0,34,5,3,0,5,13,3090774.22203125,9302570.83465243
0,35,1,1,1,4,7,1966017.5764956,7026001.38657303
0,25,2,1,0,6,9,1509265.70473146,8490794.24829405
0,31,4,3,2,1,10,2034501.49670453,6526062.32264168
0,23,0,0,0,2,2,941795.347266061,5031797.06622959
1,30,1,0,2,7,10,2848449.34603761,9519165.72231051
0,33,6,0,0,1,7,1966268.09132144,9270936.01029119
0,39,3,0,1,4,8,2014796.04080791,5778502.29422743
0,38,3,3,2,7,15,2653431.08724364,8590508.93605847
1,37,1,2,2,1,6,1266674.12734483,2581188.79580436
1,37,4,2,1,5,12,2720136.90159249,7277523.09458544
0,31,5,1,2,1,9,1455475.47841873,8997469.91802511
0,19,6,1,2,4,13,1424162.47566444,4940046.23981363
0,11,2,3,0,0,5,1454724.73907957,6605357.20353988
0,37,6,3,0,5,14,2182475.34002738,5939203.75233325
0,34,6,3,0,6,15,2411748.56565614,4604391.70522468
0,18,0,1,1,3,5,1584555.50296107,5676954.32469135
0,20,1,3,2,1,7,1488738.96902222,7641312.22877768
1,25,4,0,2,4,10,1156811.00551043,6876173.80128813
0,10,2,0,2,4,8,2005454.5905257,5153952.11639805
0,16,1,3,1,1,6,1850776.71246917,1772006.76048757
0,10,6,0,1,2,9,1536438.61592412,7491807.96372053
0,20,6,0,0,1,7,1429419.6627214,6832329.6204222
0,34,5,2,1,1,9,2134691.11623127,7464929.51616047
0,36,6,1,1,7,15,2185408.17122491,7941279.1802357
0,31,1,2,2,4,9,2000223.20086179,7475750.40879817
1,22,4,1,2,1,8,1639315.82562558,7850927.87606787
1,22,5,1,1,3,10,2329497.82740979,6667793.33366615
0,38,3,2,0,2,7,1461987.50653193,5125183.57608096
1,16,5,2,2,2,11,2371709.68485984,2388399.49276255
0,17,2,1,2,3,8,2069010.83133542,5072800.07958173
0,17,0,0,2,6,8,2251652.48043982,7325105.83024392
1,32,5,3,2,0,10,1780357.4054852,3834650.08960531
1,35,0,1,2,6,9,1312032.20446737,5115914.57696724
0,34,6,2,1,4,13,2334178.61984386,9033354.8301614
0,38,0,1,0,7,8,1933916.70302059,4939813.25941212
0,34,6,2,1,7,16,2776008.05045506,7988211.71077575
1,23,3,2,0,2,7,1956083.51636515,2857529.88985445
0,13,3,0,1,1,5,1100689.80155342,3957303.89260404
0,33,6,2,1,5,14,2528653.34690937,12172203.9139117
1,38,5,3,1,6,15,3307922.27638883,8503945.88750652
1,23,0,2,1,4,7,2059712.19090923,6187662.80853225
0,12,3,3,0,0,6,1088851.97934912,4920659.41877768
0,11,2,3,1,4,10,1905037.41545565,4720320.41610679
1,22,2,2,0,3,7,1552400.2876604,6404166.35263538
1,11,3,1,0,5,9,1944377.12546593,7930457.80769462
0,39,2,1,0,5,8,1963401.29830995,988297.447323726
0,29,5,0,1,0,6,1566120.27522842,5166532.85587455
0,22,4,2,0,3,9,2451312.27073834,6501167.62688956
0,11,1,2,1,4,8,1825279.88330192,2610638.25499527
0,17,2,3,0,5,10,1524725.24135237,4529795.305421
0,36,4,3,2,2,11,1107070.48486377,6955332.27610827
0,19,1,0,2,7,10,1692167.99564241,5970466.29885043
0,30,2,0,2,7,11,2042027.2449047,9517936.75130584
0,40,4,1,0,6,11,2109930.28976082,7431718.99622165
1,14,6,0,0,3,9,2334298.30750444,8748868.20189854
1,32,2,2,2,4,10,1558256.58362303,3852478.80137061
0,40,4,1,1,3,9,1995092.69989758,4082146.90377437
0,23,3,0,2,4,9,1923627.2859283,8519841.41141739
1,22,5,1,0,4,10,1960535.69311326,5323888.32655013
1,10,2,3,0,2,7,1688103.99582865,6358649.38294195
0,19,1,2,0,4,7,1811467.35733013,4552609.37074859
0,28,2,1,0,7,10,2106368.48826289,5739596.57639782
0,10,5,0,0,6,11,2598930.10295323,6167797.21818125
1,22,6,0,1,5,12,2764209.23909197,6565135.19770861
0,25,6,2,2,4,14,2585781.37715042,5610547.27100498
1,27,2,3,2,7,14,2636524.64015452,5977921.33309814
0,35,1,1,1,7,10,2273908.62604259,8835267.22045134
0,27,5,1,0,0,6,1203303.4591715,5563942.85427563
1,20,1,1,2,3,7,1809632.06694786,4199189.49144286
0,11,0,2,0,7,9,1604065.13793186,3332589.53138554
0,20,5,0,2,7,14,2676122.3283656,6869674.39958664
1,33,5,2,0,7,14,1658899.97346278,6945896.73191118
0,37,4,1,1,7,13,2549851.08695476,6416164.46506495
0,18,3,1,2,7,13,2029490.87880657,4408353.40309197
0,40,6,2,1,2,11,2603904.65397837,5435496.05037249
0,11,6,0,0,1,7,1648813.11892863,5870210.69552608
0,16,1,0,0,6,7,1616142.74149274,6898191.66855756
0,40,3,3,1,3,10,1609153.09276562,2065382.08150541
0,17,4,0,2,1,7,1837889.52725726,4144527.5733083
1,32,3,2,1,1,7,1112572.97779961,7163729.00726063
0,32,0,2,2,7,11,2495355.62752787,6894900.91228479
0,38,6,0,1,2,9,2337350.55510828,7951924.40957509
0,13,1,2,1,6,10,2073412.44124163,5696390.36468364
1,23,1,0,1,5,7,1866982.68952767,5894804.13239842
0,14,4,2,1,2,9,1576059.76406354,3994383.95977923
0,39,3,0,2,3,8,1890618.48874894,2723742.18341894
1,12,5,0,1,6,12,2296346.87956354,7312946.64941676
1,10,6,0,1,1,8,1805722.96637122,7328665.34630266
0,12,4,2,2,4,12,2616010.89158515,3920668.16138224
1,29,6,0,0,3,9,1538167.52177591,6945554.10298747
1,34,5,0,0,3,8,1893578.50026655,10077798.4355658
1,18,2,0,1,7,10,2146455.1126627,6220656.39503631
0,23,5,3,1,1,10,2072345.68136403,7120102.91715983
1,26,2,2,2,5,11,2886260.35037047,6465402.40021806
0,32,5,2,2,4,13,2354346.95779186,3777318.43736255
0,24,1,3,0,7,11,2249513.16556326,5369772.68947997
1,26,0,1,2,1,4,1414625.71071863,4164956.05985867
0,28,6,2,1,2,11,1825289.99025931,7556347.0424972
1,27,0,3,0,5,8,1701875.16378713,5471717.61190967
0,12,0,0,0,7,7,1930310.56451123,1133093.20104079
1,25,3,1,1,2,7,2036204.43761034,4877650.06649242
0,14,2,2,1,0,5,1554942.19431824,2444391.87146318
0,31,6,2,1,6,15,2762861.04654642,4568432.01518589
0,17,1,1,0,1,3,1634131.63102887,4373904.56180705
0,33,0,3,0,2,5,2062834.67708501,3018219.06249917
0,38,4,2,2,4,12,2023534.35259416,10435809.1192271
0,24,5,2,2,7,16,3607984.41696841,10617119.7584569
0,37,4,0,2,6,12,2520257.31226644,7259324.17126278
0,27,0,0,0,3,3,1420427.73645563,7435216.23547853
0,12,1,1,0,6,8,1748167.16125858,5547858.2598737
0,12,3,0,0,6,9,1578436.55401264,3791812.42387413
0,35,3,0,0,3,6,1393335.42437299,5498666.68337572
0,11,6,1,2,0,9,2233302.24176501,6711440.59412718
0,15,0,0,0,7,7,1319398.62932098,7013245.91181477
1,14,1,3,2,2,8,1746819.26678537,571143.527709728
0,22,5,1,2,0,8,1811872.01440456,6173845.72735297
1,24,2,1,1,5,9,1088438.78601843,5160080.97229918
0,11,3,2,2,0,7,1619330.51706412,8648457.65435556
1,38,2,0,0,7,9,1756688.45187512,6556835.76012831
1,21,6,3,2,2,13,1743557.8910671,7585943.84833465
1,15,2,2,2,6,12,2168368.52843138,4754888.95404702
1,38,1,0,0,1,2,875676.363005884,4776145.19041439
0,14,2,0,1,1,4,1311028.48424992,3134831.51129438
1,32,5,3,2,7,17,2836877.89920519,7844367.0221049
1,17,6,0,2,3,11,1858167.80907476,7435574.76425308
0,19,5,1,2,1,9,1448572.19865246,6939604.21386106
0,20,6,2,2,0,10,2442468.89737144,6682549.31115931
0,35,6,1,0,6,13,1882069.94023159,5320908.06139543
0,27,2,2,2,3,9,1604998.82927296,3243086.03553067
1,24,3,2,1,6,12,2625838.26893888,6605195.37729698
0,38,3,0,0,1,4,1633925.89658713,5266560.16403519
0,18,5,0,2,6,13,2078819.9410436,5864192.84396933
0,32,5,2,2,0,9,1432644.54475134,5439322.62185566
0,40,5,1,1,7,14,2510940.39874899,9093730.97217007
0,39,2,3,1,2,8,1879446.18093014,4686517.42595776
0,29,4,1,0,2,7,1702451.64735252,4019794.75687967
1,20,4,1,1,1,7,1769010.1122349,6057238.69547401
0,35,5,2,2,7,16,3027156.82969109,6954241.4074194
0,10,3,2,1,6,12,2144273.13157376,3214279.37023119
1,35,0,1,2,7,10,2288955.83312458,5605921.85114463
0,40,0,3,1,3,7,1758027.77947439,7110915.90323954
0,12,1,0,0,1,2,1139923.65546734,2145691.53519959
0,19,2,2,0,6,10,2036551.26528147,5019487.38346319
0,19,2,3,2,7,14,2143080.62562604,7549350.14749364
0,20,2,0,1,2,5,1174646.52861765,2534356.42523165
0,14,2,2,0,6,10,1738760.38131877,3366137.5432645
1,29,3,2,1,7,13,2638787.18805506,5865034.24917873
0,35,6,2,2,7,17,2704500.65629896,7037075.95815797
1,37,6,1,0,4,11,2081123.6532894,5520781.54837351
0,32,6,1,1,2,10,2293377.84797133,5618189.54785133
0,40,2,1,2,3,8,1978159.73429359,6742533.00538801
1,12,5,3,2,7,17,2732705.87648416,8508461.38615901
0,15,2,3,0,5,10,1965437.27234,8734839.20866349
0,16,5,1,2,3,11,2041969.34267448,4745903.17260826
0,13,1,1,2,4,8,1417369.87948341,8067199.97265029
0,33,2,0,2,7,11,1358807.9795164,6948872.80119059
1,32,4,0,2,0,6,1175661.13855105,2523834.40342416
0,30,1,0,0,6,7,1715194.37265419,5369600.67328307
0,19,4,0,2,3,9,1676439.00559235,5779699.39700878
0,13,4,0,0,3,7,1615644.06728841,3903012.96470251
1,11,5,2,2,7,16,2576598.37203929,6903917.23724803
1,17,0,3,0,5,8,1795331.95752765,4746098.68799979
1,13,2,0,2,4,8,1568937.12023994,6485472.06380267
1,24,0,3,2,7,12,2163210.83739227,8209810.26492258
0,39,2,0,1,3,6,1921912.54964712,2678361.81366685
1,29,1,2,1,2,6,1306838.8381105,4429382.65330003
1,29,1,1,0,4,6,1248044.94014698,626047.458034873
0,25,2,2,0,3,7,1704976.81587751,5844224.22850978
1,28,1,1,1,5,8,1979104.41802465,5991171.01774511
1,13,1,1,1,6,9,2016769.77421048,2600993.4397142
1,31,1,0,2,0,3,1077900.95779665,3206137.25869949
0,37,2,0,2,1,5,1488041.12612714,6753652.03292108
0,28,4,3,0,4,11,2050547.00999669,5845591.34292904
0,37,2,1,2,0,5,1511003.88915277,5882729.39563489
0,21,6,3,2,2,13,2143441.32244829,7176838.25229576
0,22,1,3,1,1,6,1406191.81673499,4441642.59823062
0,38,2,2,0,6,10,2146933.63300218,8112588.88474265
0,26,2,2,0,7,11,1991086.58174076,3719576.88582877
0,36,1,2,0,2,5,1497371.80692549,4022689.12087842
0,37,0,1,0,2,3,1183020.60653545,2140544.1871822
1,17,0,0,1,4,5,1830204.78479234,3718698.09391707
0,19,6,2,2,2,12,2559123.97026859,10318900.0516819
1,19,3,3,1,2,9,2138817.96135344,6580199.45097482
0,14,4,3,0,2,9,1876886.66852464,4191436.51197528
0,34,3,3,0,6,12,1824241.32167545,8597842.49836558
0,17,2,1,0,4,7,1586790.67268532,2991416.11508113
1,31,3,1,0,0,4,1272251.25486228,5454081.24549295
0,33,1,1,2,4,8,1710907.53513052,3230639.46798996
1,33,0,3,1,1,5,1570024.20939249,4786417.7238873
0,24,5,0,1,2,8,1974875.72468108,5985356.10135606
0,40,5,0,0,1,6,1015525.5955107,4023196.91632335
1,15,3,2,2,5,12,2287538.81696194,7738032.57621972
0,16,4,0,1,3,8,2205061.98380632,4427117.20373606
0,30,1,3,2,1,7,1944432.7916125,6353442.77001692
0,19,6,1,1,0,8,1272749.17113511,3407425.69806918
1,13,1,2,0,0,3,1437207.2537968,4399100.86317216
0,11,3,1,0,0,4,1634758.62109742,3793744.28516947
0,38,5,2,2,0,9,2083485.97655632,6743031.58455434
1,16,2,1,2,5,10,1970055.2952472,3796219.59817591
1,22,3,0,0,1,4,1323543.07456154,5731636.90009415
1,28,1,0,0,2,3,1347752.39260195,5475474.80117383
1,31,3,2,1,2,8,1025689.84329099,5538399.65402053
0,31,0,2,2,1,5,1182142.38622754,6314701.77079342
1,17,4,1,2,6,13,1651173.36960036,6620465.35118767
0,15,6,3,0,2,11,1748726.81622326,6995893.60317601
0,28,0,1,1,4,6,1611889.15631832,5517211.08967605
0,20,1,2,1,1,5,1238828.80459859,4660429.53877689
0,17,0,1,1,3,5,1382285.71566469,3176283.44947792
1,22,5,3,1,7,16,2503175.07801599,10378806.0008472
0,21,6,3,2,3,14,2296717.99707481,6721482.79577865
0,21,3,1,0,4,8,1559954.6442926,4927989.59013017
0,17,6,2,0,5,13,1975368.29275873,8991050.38304109
0,16,1,3,1,2,7,1718364.42163499,7558177.73038163
1,13,6,3,2,5,16,2392073.78583685,4070081.60632231
1,39,6,3,1,7,17,1858517.28182535,5600684.4218182
1,27,4,2,1,6,13,2526721.21429428,7844030.1235543
1,15,3,2,1,1,7,1756811.02129517,6026701.96529978
1,31,5,2,2,7,16,2110319.2662822,6404588.78351411
0,36,4,3,0,5,12,2437076.57200803,7271009.84460178
0,32,2,0,2,2,6,1766177.12821646,7512049.32012197
1,25,2,1,2,3,8,1839089.26713611,6110842.73804182
0,29,1,0,2,4,7,2200577.93938707,6708885.13535491
0,23,2,3,1,6,12,2528414.95383743,9234995.62460576
0,22,4,0,1,7,12,2186476.17578724,5017725.85531641
0,16,0,3,0,5,8,1856096.11869374,4302601.42509575
0,34,5,3,1,3,12,2397623.72554949,6925495.86964162
0,32,2,1,2,6,11,1656450.63659932,5083852.79294787
0,30,6,3,2,2,13,1565610.44627272,7749453.24555549
0,23,1,0,1,7,9,2106774.43737427,10205065.4429492
0,33,6,2,1,3,12,2163268.62842761,6986362.54227333
0,34,2,0,2,1,5,963204.284859873,5678108.97656113
1,35,3,2,0,5,10,2104295.6834954,3666055.12824964
0,35,3,1,1,1,6,1477837.07466566,4829551.88098719
0,15,6,0,0,7,13,2497578.7586661,4261476.7905042
0,11,1,2,2,4,9,1950157.07694759,9125960.64190392
0,15,4,3,2,0,9,1507778.14550872,5503960.91905161
1,28,2,2,1,5,10,2167968.9181773,2417485.62416027
0,27,2,0,0,2,4,1205412.0722929,5170712.66199444
1,12,5,2,2,2,11,1987124.90763373,9961705.32505687
0,34,1,2,2,6,11,2379775.56906399,5595751.81270012
0,28,3,2,0,3,8,1104890.00838074,7817753.50908155
0,25,5,3,0,4,12,3218697.9843567,9901427.89593216
1,37,5,2,2,4,13,2164468.07879982,5804976.23178704
1,31,3,1,2,6,12,2376598.9899502,5281599.67309834
0,22,1,3,0,5,9,2255844.39255957,6328754.1848351
0,40,2,2,1,3,8,2173268.67714145,4112123.92127786
0,24,1,0,1,5,7,1626012.56299621,4079313.20731571
0,16,6,1,1,2,10,2321404.27271211,7205263.07314596
0,38,3,0,2,1,6,1496984.73808102,3779854.91481724
0,38,4,1,0,3,8,1375234.732098,6883429.98419254
1,14,5,2,0,5,12,2054220.90736102,3586664.9869358
0,15,5,3,1,5,14,2256136.68470319,6689597.5928416
0,37,4,1,2,3,10,2062254.42409859,5043528.3457593
1,33,1,1,0,7,9,2158566.5223834,8564271.67617242
0,26,3,2,1,3,9,1706984.11616438,3726838.85234692
0,11,1,1,2,3,7,1630225.46187967,8712166.45809756
1,34,3,1,1,4,9,1974503.18681873,6915726.9940778
0,11,5,0,2,0,7,1838133.68330101,8320909.16644591
0,34,0,1,2,3,6,1658892.12090278,6439763.57791328
0,14,3,1,2,3,9,1945307.5008998,4726810.62688587
0,29,4,0,1,0,5,1527676.53529804,5453842.91296684
1,25,1,3,1,7,12,2288519.97853151,7021393.73654942
0,26,2,1,1,1,5,1329609.24025151,3662632.63550408
0,39,6,3,2,3,14,2400658.40480253,4927860.14368063
1,39,4,2,2,2,10,1702571.08837631,4311717.484044
0,39,5,3,2,7,17,3458002.1050725,6102305.75409668
0,20,1,0,2,4,7,1490310.56371858,6637212.17598495
0,14,0,2,0,5,7,1305026.53594527,5597100.36565632
0,24,4,1,0,4,9,1816480.03821188,3529521.87813422
0,17,1,1,1,3,6,2057605.60597126,6272024.96776013
0,35,0,0,0,2,2,1305444.60696001,1569675.92141696
0,36,4,1,2,1,8,1717965.19084311,2973182.95007601
0,30,5,0,1,6,12,1978360.11403166,7280086.55516876
1,38,0,3,1,5,9,1624423.6601943,3676826.32207101
0,18,1,2,1,7,11,1806667.41738102,5793278.6693782
0,34,6,1,1,1,9,2063439.59315698,6786217.2850095
0,14,2,3,1,0,6,1442303.17182075,3474017.72623002
1,32,6,1,1,5,13,2887165.43600287,6033206.78437933
0,28,5,3,1,0,9,1843894.29606245,4037439.11606686
0,10,1,1,2,1,5,1224485.2838048,6918477.44470674
0,12,1,0,1,7,9,1826923.03356773,5103455.3675617
1,11,3,0,0,4,7,1662070.49071303,7107907.91479118
0,28,3,1,0,4,8,1526634.47639067,3503273.46137495
1,37,5,3,0,0,8,2092848.76802704,5959877.10514189
1,29,0,3,0,2,5,1159798.93000524,4852725.39593311
0,30,5,2,0,7,14,1943112.32012091,7313364.77205437
1,26,1,0,0,2,3,1177812.11053836,2050457.08662477
1,11,0,0,0,1,1,1245687.29058518,2896054.88058404
0,23,4,0,2,6,12,2022188.46251271,8859799.42352676
1,11,2,1,2,3,8,1725327.65537607,4175520.86539444
0,40,5,0,0,6,11,2646137.23841534,5699810.08142392
0,16,2,2,1,5,10,2166970.4902259,5045381.40692352
0,24,3,0,2,6,11,2006145.3555904,8179300.38637238
1,15,6,3,2,2,13,1774727.76510748,5956752.35917173
0,19,5,3,2,2,12,1843431.1951162,5935138.67340684
0,32,4,1,1,3,9,1849948.21737408,6748771.30872833
1,18,0,3,0,0,3,1587275.49066774,2340542.84357897
0,12,6,0,1,7,14,2542839.19891325,9271450.22397055
0,40,6,1,2,1,10,1769557.1294658,4035326.10326489
0,20,2,0,1,7,10,2583156.89889046,2037116.33060905
0,11,5,3,1,0,9,1906548.80862937,6909656.15935294
0,37,3,0,2,2,7,1975306.11328403,7926871.07155473
0,38,4,0,1,1,6,1880397.89853391,3294723.01969564
1,23,4,0,0,1,5,1487206.46436407,5954411.94273684
1,23,0,0,1,7,8,1556562.86630148,7146478.55292241
0,35,4,0,0,6,10,1737481.73542009,3630790.76036889
1,21,4,0,0,1,5,1455608.51716787,5474623.81809673
0,28,3,2,1,4,10,1755449.19597934,5102128.67610658
0,17,0,2,1,7,10,1915330.22445885,4107693.96140643
0,33,1,2,1,3,7,1977999.48291031,5474359.58028594
1,29,2,3,0,5,10,2225514.94233458,949985.196499312
0,30,2,1,0,0,3,1017099.13766239,2381970.57516763
0,27,1,1,2,6,10,1979816.87303869,8305112.37349481
0,32,5,2,0,6,13,2332587.54233778,9178245.89881904
0,18,1,1,0,3,5,1327560.462104,5940053.13031592
0,32,3,2,0,3,8,1423285.18037453,6921846.10266852
0,29,0,0,1,1,2,1102851.00291561,4148762.85902942
0,19,2,3,1,1,7,1377620.3161202,4471175.58119081
0,31,0,1,1,7,9,1399316.59519146,5875653.34032543
1,30,5,1,0,4,10,2056680.7951184,5531708.568764
0,36,6,2,0,5,13,2455384.87950299,4503060.74581415
0,30,2,0,1,2,5,1489801.1661867,4830417.47441786
1,28,2,1,0,6,9,1917037.15649315,2702815.61614264
1,33,0,3,2,6,11,2330750.77591944,5852417.52057014
0,11,6,1,0,2,9,2141360.1733298,3962603.33363266
0,25,5,3,0,4,12,2482142.8672778,6352836.10348124
0,38,1,0,2,3,6,1641672.56428861,8167898.05911596
0,13,0,0,0,7,7,1684117.87145184,2910387.00601025
0,39,0,1,0,5,6,1724310.18187,4789056.85943896
0,39,3,2,1,0,6,1924310.24466144,3935889.9592833
0,31,3,3,1,3,10,2414995.95777774,4150653.73063674
1,39,3,0,0,4,7,2060137.19361839,3931889.5943338
1,24,4,3,2,6,15,2733505.67700444,5458381.60319889
0,14,0,3,0,6,9,1644200.84743416,4786831.84519259
0,18,0,2,1,4,7,1837128.57040088,5776349.30904858
1,15,4,0,2,4,10,2202673.2262348,5724422.41836258
1,34,6,3,0,7,16,2217399.07083195,8235819.01442385
0,39,2,0,1,0,3,1179508.22923864,694040.468975339
0,22,5,1,2,0,8,1085412.31281355,6671051.15911376
1,39,3,2,2,4,11,1928116.93035057,3979518.38625997
0,28,5,1,2,6,14,2273018.72690042,9834893.76633803
1,26,1,1,2,3,7,2111446.0752185,2391717.82915277
1,25,0,1,2,5,8,1602730.96012815,3487012.30236963
0,33,0,0,1,6,7,2465287.18702886,5427137.60256855
0,12,0,2,2,3,7,1805977.35351306,4718976.64291315
0,19,5,2,2,1,10,1689307.40691228,5614763.41162331
0,26,3,3,1,1,8,1874829.56434912,7036490.15287587
0,34,5,0,2,5,12,2227120.05397161,10626062.5916407
1,32,1,1,2,6,10,2065575.67355861,5849397.94291833
0,40,5,1,2,6,14,2072382.82439956,6254053.08459462
1,23,4,2,2,4,12,2213754.8542592,6980325.52309243
0,37,1,2,2,7,12,1998469.78993381,5370500.84603439
0,33,5,0,0,7,12,2300294.81852134,7823916.06304047
1,21,0,0,0,1,1,1524256.2217842,6205331.34025842
0,37,1,3,0,2,6,1549327.59295066,6447303.18633227
1,38,6,0,0,5,11,1939824.86768424,6440075.50318895
0,23,2,1,0,0,3,1224389.96618865,6677930.39816988
0,37,5,3,0,2,10,1994037.39950384,7428272.93864808
0,15,0,0,2,6,8,2300190.00493202,6422021.50665951
0,28,3,2,2,0,7,1712143.95587656,4648435.33808832
0,39,6,1,2,1,10,1538846.66195468,4978295.14532853
0,39,4,0,2,4,10,2179522.40740534,7557795.25616299
0,13,5,0,2,2,9,1963548.19354495,3192704.75571343
0,37,1,1,1,2,5,1320492.66396523,3176005.89114871
0,31,3,2,2,1,8,1751759.22410009,5286032.31586662
1,35,6,0,2,0,8,1657048.73299163,5111453.92745036
1,32,4,0,1,3,8,1708442.11030863,7867558.63727432
0,17,5,3,0,0,8,1764545.9652563,2659114.28718005
0,15,5,3,0,6,14,2569815.26556807,4390187.3017393
0,13,6,3,1,2,12,2101431.36947553,5990297.10659637
0,13,0,3,0,7,10,1771514.54430918,4540378.82083611
0,17,1,1,1,7,10,2116246.92803477,5713261.96920753
1,26,4,0,1,0,5,1254955.08008653,4734745.12919193
0,34,6,3,2,0,11,2590506.95296524,7451099.25016582
1,13,1,3,0,7,11,1936933.95911895,7385096.88668526
0,35,0,2,1,2,5,1532939.70743877,6329140.4736677
1,14,4,1,1,4,10,2115452.60384377,3977873.92642374
0,24,5,1,0,5,11,1375152.361589,9206240.89583063
1,28,2,3,2,0,7,2149736.85720865,4424842.52096605
0,25,4,3,1,6,14,2168382.28671043,3134366.69024304
1,34,6,1,0,5,12,2523583.2827287,3693477.66360918
0,28,5,0,2,4,11,2116007.18056065,7220107.2573008
0,12,5,3,0,6,14,2735576.83124634,7819786.18863282
0,25,1,0,0,3,4,1699598.73408046,3858589.4169866
0,13,2,1,2,6,11,2656978.03821428,7429632.05153364
0,40,1,3,2,3,9,1947779.70668407,3183747.05425199
0,38,0,2,1,4,7,1109621.90855884,5572266.47944273
0,32,1,2,2,3,8,1858661.103504,3858583.45954998
0,19,3,2,2,6,13,2757025.20444716,4505181.43229718
1,13,0,1,1,6,8,1669305.38892177,3725517.22664175
0,19,4,2,0,5,11,2374585.92252701,5952969.13885343
1,11,1,3,0,0,4,1545315.98439671,3220335.52744089
0,21,1,0,2,2,5,1626868.38518261,4570679.87877346
0,21,2,0,1,4,7,1848924.90753835,3816177.62699103
0,28,3,3,2,2,10,1894548.60260023,2889721.79160681
1,37,2,2,2,1,7,1437331.41065026,5443226.51287042
0,29,4,3,2,5,14,2834126.09086875,7089004.07149006
0,29,3,0,2,3,8,1583073.25160353,3747052.98079727
0,27,0,3,2,2,7,1564627.723364,6540012.63964007
0,12,6,3,0,6,15,2047157.27976467,7584725.42761552
0,13,0,1,0,7,8,2663748.42018685,6512951.86977405
0,19,3,0,2,7,12,2104633.54929446,8899864.2025225
0,23,1,3,2,4,10,1909817.26246536,4227149.29506997
0,35,5,2,0,7,14,2893673.26724459,6704431.63476923
1,18,0,2,0,5,7,1998467.77776229,7119235.86917385
0,25,0,2,1,1,4,1306310.02519875,3576669.25276416
0,22,6,0,1,4,11,2170147.96956304,7521721.98232714
0,32,6,2,1,7,16,2540747.38234436,7783066.4613332
1,40,6,0,2,7,15,2123966.94010802,10250478.2627513
1,19,2,3,1,7,13,2586392.33865434,7228656.5333433
0,38,6,2,0,7,15,2328994.27093977,7643745.86334911
0,20,4,3,0,7,14,2689265.84658619,4598575.84887831
0,13,1,1,0,2,4,1157106.34599562,5869831.79747534
0,21,0,3,0,7,10,1979970.9697266,5884689.09009309
1,18,4,2,2,1,9,2145659.03244346,5000267.82407504
0,18,3,2,0,0,5,919801.662382636,4310563.71294106
0,18,3,0,0,6,9,2016560.82993087,7141410.56260039
1,39,1,2,2,0,5,1809119.34600977,3414970.97768931
1,13,5,0,1,4,10,1684039.93296289,4561994.6966114
0,21,5,0,0,0,5,1327767.84730571,8368786.30862744
0,33,2,0,0,0,2,1377121.90351539,3269939.21230879
0,21,3,1,1,2,7,1349842.35145288,6583807.44169382
1,19,2,0,1,3,6,1595101.68414644,5058609.52967161
0,23,2,0,1,3,6,1979593.58234713,5016561.83220024
0,34,2,2,0,6,10,2155044.70587948,3501609.35872446
0,15,4,2,1,5,12,2012738.66950618,5801496.52106276
0,25,5,1,0,0,6,1662940.78119421,4666417.70763929
0,40,4,1,0,0,5,1310695.96118079,7026070.90796169
0,17,5,3,2,0,10,2952098.97134272,5009687.58025222
1,33,6,2,1,5,14,2563210.22271655,6362599.31797556
1,40,4,1,0,3,8,1941670.88482587,6701245.09017045
0,37,3,3,2,5,13,2001055.06812512,5403068.48972063
1,40,6,3,2,1,12,2786147.15784143,7846945.4828283
0,19,1,0,0,3,4,1653435.22947959,3863173.45354366
0,37,2,1,0,0,3,1342798.75637659,980937.968460643
0,14,1,3,0,3,7,1962907.78637754,7413297.30168391
0,30,1,0,0,1,2,802148.71434838,3706145.4178183
0,19,5,2,1,0,8,2013565.05367049,4689545.92237305
1,11,1,3,2,4,10,1592557.32389077,3027798.91937685
0,39,0,3,2,5,10,1447377.28386324,5695873.77378432
1,17,4,3,0,3,10,1786006.27959815,3752302.59742371
1,12,1,0,0,4,5,1097496.28054455,4805426.35224732
1,37,3,0,0,6,9,2232117.20738702,5681927.43777754
0,23,5,1,1,3,10,2355521.42100636,8805910.76177566
0,22,4,2,2,0,8,2049533.46333909,4403792.10332579
0,22,0,2,2,2,6,1394027.17942296,5603293.28134979
0,22,6,2,1,0,9,1661031.79631556,5419704.86008644
0,10,0,3,1,6,10,2154150.43777039,3850826.01146594
0,10,2,0,1,7,10,2317396.52367596,2393192.26745245
0,31,4,0,1,7,12,2519769.81721266,4159832.50756335
0,14,0,1,0,2,3,2061468.58514579,5577081.12520216
1,16,1,3,0,2,6,1826329.25194204,4728125.58227074
0,14,0,1,2,6,9,1892055.02461594,6729558.34798497
1,10,5,3,2,2,12,1994843.56826095,4832769.61776712
0,18,5,0,0,1,6,1764933.74715702,4730481.23942121
1,35,1,1,1,7,10,2138975.54994349,5040029.49515441
1,37,6,1,0,0,7,1454997.35046896,5007002.99287206
0,12,0,0,1,0,1,1175331.52396934,2524886.70712068
0,24,1,2,1,6,10,2016801.29585814,5770583.54697469
0,19,2,2,2,2,8,1342421.48523956,7017538.07844479
0,18,0,0,2,7,9,2115333.33092876,5855925.31710227
0,18,0,0,0,6,6,1607013.30653243,2950216.86651526
0,20,0,0,1,2,3,1055920.55892949,6372362.12351529
1,15,4,2,1,5,12,2430280.64811568,6431644.39517716
0,26,2,2,1,7,12,1420443.17509393,7067882.58470367
0,25,5,1,2,5,13,2283668.78000492,8895430.11881093
0,19,6,3,0,7,16,2864227.54573905,9856400.3220509
0,40,0,0,0,4,4,1598454.78923733,3852529.69282968
1,11,4,2,0,6,12,1942427.71427914,6751439.14544855
1,14,2,3,0,5,10,2481036.86448641,3825544.16204018
1,26,4,1,2,1,8,1897420.28836262,7137586.29139848
1,18,1,3,2,0,6,1521068.28453775,4117492.80594403
0,16,0,0,2,6,8,2127880.93652608,4654941.62737561
1,35,0,1,0,7,8,1754901.04191116,5620630.42331695
0,29,2,1,0,7,10,2119590.86704509,5082823.19796428
0,18,6,0,2,1,9,2143064.27444404,8099338.68511147
1,29,2,1,1,7,11,983960.637844554,10935565.1408305
0,34,1,3,1,3,8,1470124.14105392,6123178.71335387
0,14,1,0,1,2,4,1739770.52728523,8415166.98197024
0,22,5,2,1,4,12,2380591.88194989,5186429.54829886
1,17,4,3,2,5,14,2797332.97748067,11884134.2953692
0,20,2,2,1,2,7,1585006.43589258,2706089.97330821
0,36,4,3,2,7,16,2137654.54212843,10920966.5775888
1,22,1,2,2,5,10,2166720.86331624,6674265.67846895
1,18,4,1,0,3,8,1946547.5514362,6750444.76193507
0,32,1,3,1,1,6,1342032.48303392,4904573.13757805
0,19,6,3,2,2,13,2827769.18863339,8516823.7207941
0,19,1,3,1,6,11,2236114.90213962,7816409.03287768
0,30,2,3,0,6,11,1820540.06590517,7046832.39988027
0,12,6,0,1,6,13,2521479.66927696,3390013.17910949
0,27,4,0,2,3,9,1988454.33125955,8373642.61636769
1,21,0,3,1,4,8,1956709.24297313,4271435.1805812
0,37,4,0,1,1,6,1507477.92552257,3949032.43332711
1,12,0,1,1,4,6,1451488.18818263,7270234.97664614
1,35,4,3,1,7,15,2475368.37450869,9215090.07266683
0,40,2,2,1,3,8,2056399.7906861,4302014.723382
0,40,0,2,1,6,9,1774370.39814448,6677802.29251755
0,37,5,1,1,7,14,2242900.86578534,9256976.08419631
0,36,0,1,1,0,2,1583459.03421884,3128690.81416948
0,36,6,0,0,3,9,2040073.31421763,7820525.66386101
0,15,0,0,2,4,6,950326.827566267,3850789.52983917
0,14,2,1,0,3,6,1762499.1705977,1689020.27590465
0,30,1,3,0,3,7,1521375.36532822,4685163.38935215
0,31,3,2,1,4,10,2102716.13518512,7592536.55432433
0,24,0,3,1,5,9,1359988.05335687,6637142.79984525
1,39,1,1,0,7,9,1473146.54395042,4802788.78852183
0,20,6,3,1,4,14,2507009.61172428,5959987.4546018
0,10,4,2,0,3,9,2298596.03000988,8295093.11503564
1,39,4,3,1,0,8,1467478.86600766,4933730.3735238
0,25,5,3,0,6,14,1192742.38802847,6896909.93649922
0,13,3,3,1,4,11,1673228.68261263,7059327.1789624
1,11,0,3,1,7,11,1902299.94359698,4598906.87204575
0,39,2,2,2,0,6,1252843.06660355,3764282.74025488
0,19,1,2,1,6,10,2306557.7297538,5905175.42465471
0,18,5,1,1,7,14,2253007.47046778,9178888.73084755
0,30,4,1,2,6,13,3197365.14480417,7155518.79541011
0,18,1,0,2,4,7,1735822.2885891,6741630.83690081
1,15,1,1,1,3,6,1490128.60250417,6231155.55293679
0,22,6,2,0,5,13,2702032.6937328,8776552.95694776
0,23,1,1,0,1,3,1021941.46530857,4290711.51703796
0,34,3,0,0,0,3,1365956.65943818,3247078.54562515
0,26,4,1,2,1,8,1641547.96446655,4768649.78601481
0,21,3,0,1,4,8,1507906.82125376,6697266.57183377
0,26,5,3,2,5,15,2760406.84926311,6188533.50148356
0,20,4,1,0,5,10,1618738.98344343,7950610.84107513
0,30,0,2,2,6,10,1963118.56339219,8046698.87556641
0,37,4,1,0,1,6,1916041.55261812,4174193.23512653
0,15,5,2,1,2,10,1946595.23447843,8507227.14950929
0,20,6,1,2,5,14,2352454.38690452,4788143.51517286
1,17,4,1,1,2,8,1889080.92316046,5699045.60128218
1,40,2,3,0,0,5,1152406.78920293,2416079.46643482
0,34,0,1,0,1,2,1565435.72054849,3927013.53407738
1,21,3,0,1,1,5,1260586.46534873,4880159.8179594
1,29,1,3,1,1,6,1861495.18573613,4659490.40017301
0,23,3,2,2,7,14,2603249.78801222,5992173.87437491
0,13,4,2,2,0,8,1739507.41694734,3416220.08984963
0,23,1,2,1,2,6,1758798.03136915,5008423.8197417
0,20,0,1,0,7,8,1867967.65179753,6817209.07329232
0,34,0,3,2,3,8,1701445.20421412,5924803.08798427
0,40,0,2,0,6,8,1486617.49621377,1486617.49621377
0,11,6,3,1,7,17,2670216.70127112,10772749.0831885
0,31,4,0,2,1,7,2412312.24671428,6509826.80115234
0,26,2,3,2,6,13,2501057.36220644,6220340.83314312
1,31,6,3,0,3,12,2016640.6563836,3237035.70746247
1,32,0,3,2,7,12,2249696.47839491,7411487.62120771
1,28,5,2,1,1,9,1898424.40244031,6258344.25830802
1,29,1,3,2,2,8,1868964.62015141,6980812.93244928
1,27,4,3,2,1,10,1849009.06501956,4782567.31334329
0,13,0,3,1,7,11,2431846.20105135,5589251.31691912
1,21,4,3,1,5,13,1871421.92674012,6038847.04444616
1,34,6,1,2,5,14,2321944.32970584,6235013.2427956
1,40,5,1,0,2,8,2086472.92260509,7453269.41909778
0,39,4,0,1,6,11,1998877.87232518,4796821.36015215
0,30,0,0,0,5,5,1670408.77067225,6030951.35634294
0,38,2,1,0,1,4,1132099.78369416,3460726.07614436
1,13,3,1,2,2,8,1380112.19210579,7189622.1272468
0,25,1,1,0,2,4,1244730.36512126,3934770.96739038
0,20,1,3,2,5,11,2800281.53933163,5138460.60257587
0,27,3,0,2,2,7,2018736.52602998,3487283.6646003
0,21,1,2,0,5,8,1205042.01051359,7638714.66613399
1,39,3,1,2,1,7,1968619.76554337,3857236.08156531
1,11,5,2,2,1,10,1578467.15131601,5423558.09175497
0,19,5,2,0,4,11,2541132.30236961,4902718.89146644
0,39,5,2,0,4,11,1915145.74763224,6035391.15519828
0,16,2,1,1,6,10,2181591.96602821,8386854.90504643
0,28,5,2,0,7,14,3054555.22957993,5381838.61077823
0,12,5,2,2,6,15,3404090.51686209,4111786.08036493
1,22,2,1,0,2,5,1674837.05903471,3724667.09050453
0,11,0,0,1,4,5,1388292.28979287,1765151.58494759
0,11,3,0,0,4,7,2092359.10006854,5109978.16949065
1,35,4,0,0,0,4,1478806.63427759,4307810.4951262
1,15,5,0,2,3,10,1190980.03766217,6482931.94530581
1,32,2,0,0,0,2,1036131.71703002,1384959.41407768
0,38,4,0,0,4,8,1755760.1656042,6154231.63537208
1,35,3,2,2,5,12,1753706.65226143,8868050.10013619
1,31,6,0,0,2,8,1182921.38766571,3449188.66066216
0,20,3,2,1,1,7,1521230.95782527,4172742.25852427
1,14,4,1,2,7,14,1942096.06893575,10258837.6721022
0,24,4,0,2,7,13,2981627.05081737,7398919.45917875
0,21,4,2,2,3,11,1691059.14687772,6364565.80316674
0,27,4,1,0,6,11,1635213.48312439,3214389.55667567
1,18,1,0,0,4,5,1790722.08084445,3975245.80760239
0,38,3,3,2,7,15,2407472.0330344,4187682.92743866
1,12,3,2,1,2,8,1774059.59822935,6124340.91781432
1,37,4,3,2,1,10,1497782.63252463,5604506.3991018
1,36,5,3,0,3,11,2199208.09465283,5978146.1230625
0,33,6,3,1,1,11,1990124.23979969,6785254.69727932
0,12,1,2,2,6,11,2175285.68897056,5379908.76212052
1,23,1,2,2,5,10,2053183.83652239,5691727.32803531
1,17,0,0,1,6,7,1566361.34900667,4375992.01938614
0,25,2,3,0,4,9,2269321.66101079,5581692.8319503
0,17,4,0,2,5,11,1582621.63703976,7988313.85724624
1,15,3,2,1,7,13,2923384.83052029,8734975.75695278
0,14,1,0,2,5,8,1794039.01286572,7853742.80289373
0,14,5,3,0,5,13,2256717.69382283,8447695.76034985
1,17,3,2,1,4,10,2290739.43874116,5374899.11377495
0,32,3,1,2,5,11,1680827.45093083,7670871.90768345
0,26,0,2,2,1,5,1805095.63588266,4065024.82535305
1,39,0,2,0,2,4,954354.913909994,3847521.46212639
1,24,0,0,1,6,7,1614075.2016387,4175949.40187027
0,13,3,3,2,0,8,1990403.2564999,7890425.89712202
0,28,3,0,0,3,6,1733908.63035897,6405608.86533126
0,28,6,1,1,3,11,2178250.00500301,1785531.48131647
0,37,2,3,1,7,13,2769131.93724583,8171063.66611931
0,12,0,2,1,0,3,787571.833932141,5711569.44734817
1,17,0,3,1,0,4,1322666.60168836,5335283.24093694
0,37,6,3,2,2,13,2140383.2043475,9767180.70358922
0,26,0,2,2,6,10,1811878.05691322,5252283.36885114
0,37,6,2,2,0,10,2046728.08939153,8412857.73146121
0,36,6,1,0,5,12,2081056.27648654,9024357.97056852
1,38,6,1,1,3,11,2414894.38681196,6140639.75915506
0,12,1,2,0,7,10,2007061.46715678,3500215.09374752
0,33,2,1,1,6,10,2163324.1883216,5585872.63457059
1,22,5,1,1,3,10,2342389.53419735,5389003.44020875
0,15,1,1,0,5,7,1709431.14146961,4263129.44000722
0,11,5,1,1,7,14,2896372.46656943,6049443.18943665
0,23,4,0,2,3,9,1425345.8932666,6074472.71051974
1,39,5,2,1,7,15,2836649.88462645,8671999.34331786
0,34,2,0,2,5,9,1853394.6112524,6030210.6372458
0,28,6,3,1,6,16,2169461.26171337,10488702.774385
0,14,6,2,0,6,14,3012436.11196355,7856190.68308287
1,26,6,0,2,6,14,2555331.47398439,2719622.65330729
0,34,1,3,1,2,7,1856462.24259463,3229660.58790181
0,20,5,1,1,2,9,2153280.47612514,7244154.69086318
0,15,0,0,1,0,1,992080.013763408,3329531.90763907
1,33,5,2,1,0,8,2122703.4408639,5712899.31969939
1,28,4,1,0,2,7,1568071.36637847,6423526.98455853
0,20,5,0,2,7,14,2944704.96076671,10241098.9471375
0,39,4,1,2,4,11,2379452.30100148,4627479.03443406
0,12,6,2,0,4,12,2247073.63027778,6229716.62173883
1,26,2,1,2,0,5,1613318.33040024,6031493.04927017
0,34,4,1,1,0,6,1300002.45222324,4699790.74872959
0,40,4,2,1,2,9,1938477.17703272,2287727.22362986
0,13,2,3,1,4,10,1504726.27123523,6500508.80317531
1,31,2,1,0,7,10,1235645.47756537,7988640.53050064
0,14,3,1,0,6,10,1833273.43762145,5359040.72443355
0,40,2,0,1,4,7,1952159.15761166,5980402.93861794
1,17,2,2,0,1,5,1532447.08490748,5763559.53355158
1,35,1,0,2,1,4,1297741.29514177,1710739.75557843
1,37,5,1,0,4,10,1931677.84839209,6647440.42964383
0,21,0,3,2,7,12,2293368.00434215,6585951.20168736
1,15,1,1,1,4,7,1863043.3394361,4169362.80371443
0,38,3,2,2,0,7,1616206.69404089,4531097.40022735
1,10,3,0,0,0,3,1192028.63079414,1809882.53782092
0,35,4,1,1,6,12,2241798.91898293,8556147.917729
0,27,4,2,2,0,8,1954426.49688748,4973732.31438919
0,26,3,2,0,0,5,1359021.19835638,7132265.21861244
0,20,4,1,1,1,7,1853451.06692187,5023015.76862479
0,11,5,2,0,2,9,1632761.37854449,4115872.60293837
0,34,6,0,1,7,14,2888018.16467884,7061336.17648825
1,30,2,2,1,0,5,1576888.27737233,4682223.27734813
0,13,4,3,0,6,13,2351698.88694645,4430468.25691354
0,18,4,1,2,0,7,1750675.94973051,7015384.38857396
0,38,0,3,2,1,6,1475226.75516808,2288860.66566686
0,25,1,2,0,1,4,1266621.52088928,2067860.54293782
1,23,2,3,0,2,7,1898056.99728714,5573802.6010857
0,29,5,1,1,0,7,1536529.85883333,4636303.34437985
0,32,2,0,0,2,4,1657521.30044153,3931305.66464714
1,13,1,0,2,7,10,1839908.19455971,5806589.46740485
0,21,5,0,0,7,12,2528024.35275978,8789711.27004649
0,12,6,3,2,0,11,2596346.89251824,4179081.00303882
0,31,0,0,0,6,6,1812237.64713834,2426634.1144535
1,38,3,2,1,0,6,1402827.98369445,6904229.83120658
1,16,6,1,1,7,15,2507107.85590715,12073594.0266106
1,16,0,0,2,2,4,1430109.38571216,4709273.01579499
1,40,5,0,2,4,11,2182670.25110193,7766874.60722535
0,33,0,3,0,2,5,1273852.82884553,4084486.38584916
0,20,2,3,0,7,12,2370265.21737654,5108485.93357201
1,13,2,0,1,5,8,1894819.6494681,4712713.40768065
1,20,4,0,1,4,9,2292617.51552893,5906716.55321119
1,40,0,0,2,4,6,1375591.15760304,4200978.43254931
0,27,1,0,2,6,9,2246336.47358932,4360162.03948922
0,19,3,2,1,3,9,2273203.67307564,7883318.31612675
1,30,2,3,2,7,14,2495815.39097239,8143698.55023619
1,16,3,2,2,5,12,2322634.6200106,9587341.58517019
1,32,0,1,0,5,6,1738363.03142958,4877342.41633227
0,12,4,1,1,7,13,2380050.36947592,5811941.42401639
0,12,4,2,2,4,12,2173403.62399225,5834625.0160137
0,33,0,0,1,1,2,1327157.58307275,3286936.06474854
0,39,3,1,0,6,10,1858450.20551783,3275018.45118787
1,28,1,0,0,5,6,1773737.98840777,5043472.28038622
0,16,5,2,1,5,13,2437040.53764254,8092459.27151313
0,32,6,1,0,4,11,2195744.09622062,7219448.85781639
0,11,1,3,1,4,9,1933560.28484615,7640655.85116577
0,14,4,1,2,1,8,1772168.35857765,5883735.19905471
1,12,6,1,0,0,7,1831931.15196196,7338099.99797862
0,24,0,1,0,7,8,1076585.38908893,3496418.06518038
1,37,5,1,0,3,9,1899096.97998436,7556556.01595792
0,12,3,1,0,7,11,2840511.84922285,7381822.49792832
0,13,0,1,2,7,10,1844702.13612796,4258673.35311959
0,32,5,0,0,3,8,1986128.55814715,4145327.2551101
0,22,5,3,0,2,10,2521040.65216025,5029293.37006232
0,33,2,3,2,6,13,2770880.35547034,8617424.62101194
0,37,3,2,1,2,8,1717590.31161303,6180207.87516196
0,14,4,1,1,4,10,2064979.59537059,9602556.14169424
0,20,0,2,1,6,9,2183725.47370764,7035768.16416054
0,24,3,0,2,7,12,3061026.51978921,8251317.6531591
0,18,4,0,0,5,9,1691249.59745941,9555413.23067973
0,14,6,3,1,4,14,2687536.58298238,7724423.58322518
0,36,3,3,2,6,14,2583670.58296895,5865007.4898343
1,33,6,2,1,4,13,2047065.00855563,3069200.59393985
0,11,4,1,2,3,10,1940156.51998639,5731382.81602491
0,20,4,0,1,5,10,2415676.42632507,10202855.6006504
0,36,5,3,1,5,14,2445688.59642488,5967791.79398247
0,18,3,3,0,6,12,1796163.42605321,5396055.99781175
0,12,2,1,1,5,9,2123311.10885472,4704193.43598775
0,18,2,3,1,1,7,1739908.16705496,6355802.60312572
0,40,5,1,2,3,11,2329892.19900191,5865089.21393058
0,36,2,3,2,5,12,2427117.99273164,8919140.65617104
0,31,6,3,1,4,14,2744565.58716662,7387180.13193042
1,37,3,2,1,0,6,2007017.1971863,5932434.94084301
1,18,0,1,2,7,10,2344720.87275234,6790105.08879779
0,17,1,2,1,4,8,1439403.6940399,3519776.07037031
1,28,5,0,2,2,9,1934438.08899719,6404106.61708262
0,11,2,1,2,4,9,1934597.08945338,4614075.46983667
0,36,1,2,0,5,8,1892792.39389698,4071196.37900766
0,32,3,2,1,0,6,1707948.56476359,3997490.66796492
1,28,5,2,2,0,9,1880795.82852647,5447007.18729352
0,25,0,1,1,4,6,1651852.4646848,4896123.93021
0,25,4,3,1,3,11,2330806.3052789,4996420.50543883
0,16,2,2,2,0,6,1605913.66344558,5586341.66817807
0,37,3,1,0,7,11,2231271.12343002,4232836.4300408
0,16,2,1,2,2,7,1266494.63376442,3182085.09474563
1,17,6,1,1,3,11,2533670.43154471,4778201.67975806
1,21,4,2,0,7,13,2145986.03253564,3913423.52612023
0,23,1,3,2,5,11,2337402.10008018,3958154.79428061
0,35,1,1,0,5,7,1952699.97597007,6243056.64520352
0,24,6,1,0,2,9,2123957.87010991,7724629.96433393
0,26,6,2,1,1,10,1648970.41646933,11243778.825932
0,12,2,1,0,0,3,1383612.1633918,4110800.38975913
0,25,4,1,2,6,13,1965668.39903691,5677314.83765386
1,25,4,0,0,3,7,1134298.38648068,5951057.24514772
0,22,6,2,1,4,13,2431442.92274343,8939415.57654054
0,13,3,1,1,2,7,1716263.91310591,4679358.2830324
0,15,0,1,2,5,8,1654922.05333358,3913463.90752339
1,19,4,2,1,2,9,1758947.33645716,8100583.81120847
0,11,1,0,0,5,6,1967568.04026858,5969108.98290498
0,34,5,1,0,5,11,2360483.52713385,3557656.35753396
0,35,0,2,0,0,2,1534288.99521217,6098019.27043293
1,22,5,2,1,0,8,1159238.89242148,7193227.69270764
1,21,2,2,2,5,11,2356280.33333127,7543702.24613095
0,28,2,3,2,2,9,2084833.13350867,5530898.3248912
0,30,1,2,0,6,9,2443295.270299,6028877.44846894
0,36,0,3,1,7,11,2217954.88937206,6743047.74018402
0,14,0,2,2,6,10,2336949.08450283,4135347.97410493
0,17,3,2,1,1,7,1578212.71623114,4691661.28945535
0,32,1,3,2,3,9,1888728.46527344,5054366.22981084
1,21,1,1,2,3,7,1765008.42436786,4734295.63989146
0,35,3,3,2,2,10,2026098.81574365,5424786.57881933
1,20,2,3,2,4,11,2346943.76904037,9140870.54410935
0,13,1,1,0,3,5,1479326.89787792,2833904.56351461
0,26,0,0,2,6,8,1897285.65123413,2846392.25269336
0,22,2,1,1,4,8,1442733.91777047,6996877.18347025
0,16,4,1,2,0,7,1315521.20204635,6347353.19417962
0,37,5,1,1,0,7,1842610.87725477,5824085.41495237
0,10,3,2,2,6,13,3298603.92716353,8144632.96731913
0,15,3,3,0,5,11,2115010.66550077,7915676.03471887
0,26,5,2,1,4,12,2349021.15874372,7768741.08279416
0,16,5,0,2,2,9,1901794.60211496,6576876.91462727
0,30,5,1,2,3,11,2075437.60224739,8816919.68572525
0,23,2,2,2,4,10,2374148.73564147,7766275.02803291
0,26,4,3,1,7,15,2255782.99758707,6225233.80698593
0,28,0,0,1,1,2,1378240.02641485,715467.686557247
1,28,0,3,1,0,4,1416240.32842748,5757067.60006504
0,38,3,1,2,6,12,1501657.93622679,1881166.9626303
0,11,3,2,0,1,6,1583899.73643353,3674422.92468932
0,16,6,3,0,0,9,1665900.74931478,6600734.12617114
0,28,2,0,1,0,3,1024433.20595681,1229891.42956568
0,40,3,2,2,5,12,2484289.00743278,7432578.70291654
1,21,6,0,0,1,7,1578136.28302962,6160687.73736673
1,33,1,0,2,3,6,1998702.51467554,6525245.2179666
0,38,0,1,1,3,5,1423124.3162476,5272472.04927803
1,36,2,3,1,0,6,1455992.02076125,7794068.51309636
0,26,5,2,0,6,13,2333777.51976608,6055031.2382285
0,29,5,1,0,0,6,1580074.77346123,5835273.22850419
0,37,2,3,1,5,11,2523863.77247118,7482085.3173196
0,35,6,0,2,6,14,1939944.83289841,6876355.75262178
0,17,2,2,0,6,10,1801568.09721972,5646600.163725
1,34,3,2,1,6,12,2914297.14933951,7122615.9478192
0,33,6,1,1,0,8,1775876.8576304,7267074.44610554
0,16,6,2,1,6,15,2827410.77642595,3746260.91320034
0,23,3,2,1,3,9,1837046.49547532,4403277.27810159
0,21,1,3,1,3,8,2039948.68921721,7102978.00045467
1,28,4,2,2,1,9,1425039.27665416,7897415.34363667
1,36,0,0,2,3,5,1764154.49268373,3736813.97881582
0,26,4,2,2,1,9,1644593.92692461,3318820.53526573
0,36,0,1,0,0,1,1063194.46290235,3432540.36799719
1,16,2,0,1,3,6,1026495.0531095,4360364.653161
1,21,2,2,0,2,6,1536018.4601151,3770950.26866397
0,10,5,1,0,0,6,1335037.46046136,6247104.53509719
1,27,3,2,1,5,11,2097338.58367238,6427314.44020906
1,23,0,0,0,4,4,1483967.63614961,4470323.07790698
0,14,4,0,0,1,5,1567683.07403996,4477901.40906617
0,27,1,1,1,5,8,2229650.13658816,4270095.14830613
1,19,3,0,0,4,7,1246559.90490073,5141923.24714792
0,25,0,0,2,4,6,2223663.30191091,5403409.35455504
0,33,0,2,1,6,9,1906390.19889971,2400884.75748078
0,24,0,0,2,2,4,1410430.9737081,2815309.88867811
1,27,5,0,1,1,7,1814109.18126509,5754035.37761008
0,37,6,3,1,3,13,1976768.19997711,7617560.87787204
0,36,0,0,1,5,6,1812820.28694338,3321818.07947932
0,23,0,3,0,0,3,1208245.29964347,2728811.85740613
1,38,3,3,1,1,8,1816005.88751871,5052893.60368462
1,35,4,2,2,7,15,1830275.56558898,1401143.28956207
0,28,0,3,2,6,11,1563372.13523152,8573903.07655747
0,38,5,2,1,3,11,1803505.47705359,4805284.42018329
0,35,0,2,2,3,7,2098098.53942574,5322241.98697759
0,36,4,2,0,1,7,1894259.91190857,4177755.75650458
1,10,6,2,2,1,11,2044780.23889256,6885202.06800573
1,27,2,1,2,7,12,2222130.77866214,8492996.06176932
0,29,5,1,0,5,11,1497146.9373482,5798562.82154722
0,14,4,3,1,2,10,2167508.90302953,4989017.96679633
1,19,5,2,2,3,12,2406286.6008116,4728596.50302751
0,22,1,2,2,7,12,1877090.50567946,6190785.82653029
0,12,6,2,1,0,9,1684107.5139531,3632845.49873746
0,15,4,3,2,0,9,2005359.88355395,7803169.65541468
0,39,3,2,2,3,10,1446874.65318839,6146021.26148035
1,14,5,1,0,6,12,1985157.75534743,5126431.40381359
0,22,1,2,2,3,8,1478888.88135607,6851638.07945128
0,20,4,2,1,0,7,1720146.97084396,7171513.49680231
0,13,6,0,2,5,13,2308340.32413605,8160166.87588641
1,20,0,2,1,0,3,1630397.52935378,1650316.47098267
1,18,0,3,1,4,8,1853331.96178157,5389850.15910916
0,20,2,3,0,7,12,1786548.84430569,4101110.3206021
0,20,1,0,1,3,5,1483256.98611087,4260380.52213319
0,32,2,0,1,4,7,1581455.60215577,7662900.57476893
0,40,4,3,2,1,10,1538182.24357539,8144187.12043533
1,40,0,3,2,4,9,2193770.15728576,5192099.47843347
1,21,4,1,2,5,12,2583904.28816195,5931582.03281201
0,13,5,2,1,2,10,2269640.60333871,7504350.84340199
0,36,4,3,2,1,10,1482795.43920248,8243923.36857369
0,26,2,3,2,1,8,1510868.29727746,5376033.41824144
0,28,2,3,1,3,9,2123235.34677902,5171026.64153571
0,38,6,1,0,5,12,2358280.7545107,6491338.86136043
0,37,1,1,1,4,7,1964129.3004809,3112488.87417497
0,34,3,0,1,6,10,1868335.29421791,3951845.84376123
0,26,6,2,1,4,13,2299016.29399489,7209508.75761558
0,37,0,1,1,5,7,1605476.73587135,4559891.41908763
0,10,0,0,0,6,6,1205255.66097668,4915488.42115792
0,34,6,2,1,5,14,1859093.68004012,9026479.60502292
0,34,1,0,2,3,6,1373335.7069131,4963176.83692558
0,26,6,1,1,0,8,1803294.47561816,6284455.30927022
0,19,1,3,1,5,10,1604350.63761795,5615206.93539609
0,14,0,1,0,1,2,1108880.78014074,3665772.78410762
0,28,4,1,0,0,5,1282753.10096516,5927886.23394261
0,10,1,3,0,4,8,2120548.81367104,4279529.78008906
1,31,4,1,0,2,7,1468757.90893734,3731917.47605791
0,38,4,1,0,2,7,1631050.47848787,4273908.13204213
1,14,6,3,0,6,15,2637579.6220597,5226809.24097622
1,33,0,2,1,1,4,1359990.88159569,3592574.08455671
0,31,2,0,2,1,5,1326391.76137503,6948392.83432532
1,17,4,1,2,5,12,2499432.16852484,7578219.98814738
0,15,0,2,1,7,10,2229348.38194666,8278143.03435198
0,16,1,0,0,0,1,710976.98354471,3601114.74671226
1,24,2,2,1,7,12,2577623.1676193,6851949.11398231
0,18,2,3,0,3,8,2040598.1292978,6488919.89905215
0,33,3,2,0,6,11,1814941.66125281,5946704.48221914
1,31,0,1,2,3,6,1448618.0153384,5140144.69817908
0,31,2,0,1,5,8,1732272.92182068,4926138.93232454
0,22,4,0,1,3,8,1593111.2767856,5457723.41476
1,21,2,3,0,6,11,2069291.3144381,5676795.66414423
1,37,5,3,0,1,9,1258365.21193062,3120032.99006956
0,38,2,1,2,4,9,1905393.53139431,5518163.55295908
0,38,1,3,1,7,12,2087405.31333261,8216428.93483163
1,10,6,3,0,6,15,2406829.37400979,6557262.27291527
0,37,5,2,1,5,13,2301326.3548821,6831330.90815474
0,19,1,0,2,6,9,2128232.44111264,3592416.59884644
0,34,0,3,2,4,9,1350754.35099221,5040443.56672414
1,33,0,1,2,5,8,1832843.38064204,5811778.07024342
0,31,4,3,0,2,9,1447859.57635044,6440015.18608734
0,30,6,3,2,3,14,1659314.41316191,8253331.16005576
0,40,6,0,0,7,13,2782846.50436253,6734647.01369452
0,22,6,1,0,4,11,1760667.41413291,3518096.36849568
0,26,4,2,1,3,10,2616538.23049503,3440996.56374398
0,12,0,3,1,7,11,2389914.47499866,4874577.28618851
1,23,6,2,1,3,12,2217714.63400983,6336567.52167309
0,35,1,0,0,1,2,1462259.06000309,3711875.37996297
0,28,6,3,0,3,12,2293551.99910703,5163509.88236581
1,10,1,1,0,0,2,1187231.13258645,2740107.32010302
1,31,5,0,1,4,10,2125569.17177267,7808333.105728
0,36,1,3,0,2,6,1421008.23552659,3633339.54505641
0,19,2,0,0,0,2,1518701.49432227,3115557.01620895
0,38,0,3,2,0,5,1347231.64800945,1202426.98074158
0,25,6,2,0,6,14,2271818.66988701,7932565.56807892
0,10,0,2,2,7,11,2101019.15059515,7251555.07175029
0,37,1,1,0,3,5,1375525.53021133,3987749.40826371
0,31,5,1,1,7,14,2968918.7971641,7670220.33574139
0,38,1,1,1,7,10,1817794.14156318,6864080.59595849
0,19,0,0,1,5,6,2047692.96332076,4146212.75141063
1,20,2,2,2,0,6,1600345.10915736,5472711.5296846
0,37,1,0,1,1,3,1436980.56628831,3824930.43469735
1,13,2,2,0,5,9,1603408.99354309,4972284.46884362
0,16,6,1,0,2,9,977588.076599874,2811535.60623448
0,38,2,1,1,4,8,1838903.69684992,5765236.02246055
1,38,6,3,2,6,17,2139720.84606644,5082798.03969841
1,25,4,3,0,1,8,1777533.85057958,5618893.26075116
0,36,2,0,2,5,9,2258788.21078784,4706053.07215974
1,16,0,2,0,4,6,1220755.36992752,4592739.49190299
0,31,2,2,0,7,11,2237831.7599511,7209749.11250302
0,19,4,3,1,6,14,2835237.77563837,8298985.17345044
1,16,5,0,0,1,6,1775521.91788279,2724023.93820967
0,18,3,3,1,4,11,1820569.82018324,7555510.82275296
0,32,0,0,0,4,4,1618330.16998876,1212530.15613599
0,34,2,1,0,0,3,1251377.55694289,3274362.75167012
0,37,3,2,1,4,10,2084841.00291263,4821380.24802907
1,23,5,3,0,6,14,3092459.80865349,5467535.2177888
0,19,5,0,1,1,7,2162588.70878168,2428890.4571009
0,40,5,3,1,5,14,2541255.62695737,8047717.91384439
0,17,5,2,1,0,8,864149.918002159,6103542.08909124
0,26,5,0,0,3,8,1797458.57353894,7646079.34108563
0,20,2,0,2,3,7,1314602.38932139,4449989.17927315
0,17,4,0,2,4,10,2217353.93804082,8064850.73531222
0,16,3,2,2,5,12,2487102.62063638,4993966.35961341
1,32,5,0,0,4,9,1657287.01906769,5929787.44607575
0,24,6,2,0,5,13,2614222.97984747,5875504.75181443
0,38,2,2,0,3,7,1681419.73668857,4206514.25850629
1,14,2,3,2,7,14,2514163.20391608,5137660.62128139
0,30,5,0,1,5,11,2761485.27773835,5330285.31431609
0,30,5,1,2,5,13,2298481.13121013,8390962.33942239
0,12,5,3,1,7,16,3083295.01242114,9759605.59309713
0,24,2,2,0,2,6,1608040.46452925,5639900.30694805
0,14,1,2,0,1,4,1686920.44313607,7548159.02970069
0,14,1,3,1,7,12,2547956.58366146,6138317.07249961
1,34,2,1,1,1,5,1613044.14410817,6100592.5047388
0,29,2,1,0,5,8,2086171.51024888,7681097.2456411
0,12,1,3,1,7,12,2594617.73242691,8928842.46558663
1,12,3,2,2,2,9,2312450.70706088,6345253.43731586
1,17,0,1,0,7,8,1640579.87108427,3133328.94178865
0,30,3,3,2,1,9,2313144.87407195,4198149.01327431
0,25,2,0,0,6,8,1463572.6126441,6190725.56968362
0,22,1,3,2,6,12,2157641.21382521,9016828.48315764
1,37,5,2,1,1,9,2099631.81697511,6621947.30018305
0,30,6,2,0,3,11,2615141.14310628,7683122.33181529
0,38,6,0,1,7,14,3293121.10844875,7984757.28204906
0,39,6,2,2,0,10,2453333.67597262,6817018.72564175
0,35,5,0,2,4,11,1966676.82574219,9677832.88268964
1,31,6,0,0,3,9,2057131.47752078,1819803.02658067
1,15,0,1,2,2,5,1543737.77948242,5815119.53650707
1,10,0,1,1,5,7,1220511.83193548,4884680.48509743
1,28,4,1,1,6,12,1634673.21599016,8458776.70223398
1,21,6,0,2,2,10,1958209.46374026,8551646.53779631
0,14,2,3,2,1,8,1896695.89571491,7209813.80964369
0,38,0,0,0,7,7,2175703.07255204,6954922.69155942
0,35,0,3,2,0,5,1580639.47151525,7549936.28465955
0,14,0,1,2,5,8,2063681.28621318,3926574.05633467
0,21,5,2,1,0,8,1748206.34920247,3069597.6348793
0,40,1,1,0,7,9,2692974.86094,7806532.16946896
0,27,3,2,2,4,11,2445538.83798284,6426888.75026219
1,28,2,2,0,3,7,1646738.74709025,6893499.20598647
1,16,2,1,0,4,7,1575194.83138047,4959323.86428407
0,32,0,1,0,7,8,1312922.58445753,6136306.96069873
0,17,6,1,0,3,10,2354690.28707855,4213736.34201972
0,16,4,1,2,3,10,1603855.65168471,4299763.85220341
0,29,3,3,0,1,7,1249157.50637166,4186489.65348044
0,21,0,3,0,5,8,1722878.30079109,5424412.27663936
0,18,1,3,2,3,9,2178095.5067027,5193100.58840187
1,13,6,1,2,7,16,2686326.45788804,6180625.89066174
1,37,1,2,0,3,6,1507242.15814807,4917282.46070837
0,28,2,3,0,5,10,1312266.12791799,8365626.91279942
0,27,1,1,0,1,3,1078260.04507327,4421264.12980539
0,40,5,2,2,5,14,2147311.65853851,8465140.70862085
0,15,5,2,1,6,14,2128669.39887623,6677380.57741441
1,14,6,1,1,2,10,2338991.52026907,4346566.35116578
1,19,0,0,0,1,1,1206856.07615887,1505703.3619108
1,26,1,0,2,6,9,1593359.09492785,3971263.76542267
1,22,0,2,0,3,5,1419862.741453,3973733.68361428
1,11,0,1,1,1,3,1299673.26521168,7009190.96906138
0,20,4,3,2,7,16,2831880.67601762,7251311.01770487
0,20,4,2,1,4,11,2310636.25171538,7274711.1277845
0,19,0,1,1,0,2,973102.717810152,4372665.34699941
1,13,6,2,2,5,15,2507142.26463804,5788288.04751576
0,38,6,1,0,7,14,2709235.89146686,8065899.91098193
1,34,1,1,0,2,4,1544347.43492325,2412690.63558114
0,24,5,0,0,1,6,1787366.80568008,5940651.49291932
0,20,4,1,0,3,8,1869786.89390484,4863849.569655
0,18,2,1,0,0,3,1649872.23935759,3538096.31607004
0,16,0,2,0,3,5,1285361.34005852,3190576.33967634
1,32,1,1,0,4,6,1584726.77603098,1558795.11192318
1,38,0,0,0,0,0,1216070.88922952,4006119.21548121
1,38,3,1,2,1,7,1618983.15824093,3127773.69583175
0,12,1,1,1,3,6,1091105.06056118,5454664.91937977
0,17,2,1,1,4,8,1526418.40791916,3378198.02910881
0,27,4,3,1,0,8,1713145.90913067,3504719.9233802
0,23,3,3,0,2,8,2025289.24766111,7834768.88354393
1,33,5,3,2,4,14,3520129.2099498,4339466.75284722
1,25,6,0,2,0,8,2052382.7837464,6148200.34255256
0,12,4,1,1,0,6,1750140.84491912,3763021.15893997
0,10,2,0,1,2,5,1017129.85455133,6077182.01584666
0,31,2,0,0,5,7,2082994.89035416,4633035.09101756
0,11,0,2,1,6,9,2134095.7768391,6198042.06888247
0,30,6,2,2,5,15,2226540.64025356,9394094.36949023
0,18,1,2,2,5,10,2150461.82216072,7156911.49695368
1,37,3,1,0,4,8,1330457.84322149,5402354.60519551
0,19,3,3,2,0,8,1896246.85399219,6040710.31488099
0,32,1,1,2,7,11,1348045.32132608,5040386.79414966
0,12,4,1,2,6,13,2461434.75535479,7729909.16657864
0,20,1,2,1,3,7,1577114.51566025,6521930.66149079
0,14,3,0,0,6,9,1679205.48744606,5916692.17008887
0,11,2,1,1,6,10,1593143.67770203,7373704.58904054
0,17,3,0,1,6,10,1619687.38635003,4105785.13234849
0,21,2,2,2,7,13,1588945.89095925,8024221.66529211
0,22,5,0,0,5,10,2185269.75079009,7612071.343862
0,25,3,1,2,7,13,2037805.47837208,4934392.84498307
1,18,5,3,1,5,14,2396492.50080187,8107965.36868787
0,17,6,0,1,4,11,2068180.59703173,8373350.42847376
0,24,4,1,2,7,14,2785294.24536638,8395205.86771161
0,34,4,2,1,1,8,1859830.02265667,3449213.55026237
1,17,5,2,0,0,7,1944428.03001929,1879624.42783701
0,21,4,3,0,7,14,3360353.40120491,7608877.69175332
1,31,4,1,2,7,14,2833863.01395145,6526128.87565162
0,29,3,0,0,0,3,1591245.09117116,1255725.3401056
0,39,0,1,1,4,6,1915843.47463259,5820313.06334759
1,16,4,1,0,0,5,1446506.63831224,5263739.07965054
1,40,2,0,1,5,8,1796598.78321361,3590426.01069049
0,36,4,3,0,6,13,2105331.56118088,5082560.40885224
0,38,2,3,2,6,13,2678853.20819626,7495873.50970487
0,16,1,1,0,3,5,1548513.19557249,2272340.00772172
0,17,2,3,2,7,14,2090955.2832046,6864763.3535585
0,39,2,3,1,2,8,1549174.59954952,3674517.60679157
1,23,0,0,1,6,7,1736487.89726474,4382460.56492049
1,28,3,3,1,4,11,1651489.16193971,5563733.04648624
0,31,4,1,0,6,11,2007428.53645342,4929023.9671511
1,31,1,1,0,1,3,760236.797916216,6485348.89011268
0,23,5,1,2,0,8,2175380.77924334,7964925.34246287
0,24,3,3,1,1,8,1770749.06077693,2824587.23704577
0,12,1,2,2,3,8,1744176.81262385,6683231.45472692
0,39,2,0,1,2,5,1633245.94946843,5231611.73812441
1,28,0,2,1,4,7,1609121.54376146,4504877.15319313
0,37,2,1,1,0,4,1171784.82754227,4928869.42809375
0,21,5,0,1,2,8,1589831.86030546,4769809.42520427
1,17,0,3,2,4,9,1761349.15521822,6214046.92754624
0,11,4,3,1,3,11,2236962.07145186,5693738.71959629
1,40,3,3,0,3,9,2112942.03672112,4974206.94972012
0,28,4,1,0,2,7,1941840.73946437,7495207.22605731
1,39,4,0,0,2,6,1709153.43583043,6540939.64590538
0,29,3,2,1,3,9,1862436.07300345,6075141.75892988
0,23,6,0,0,7,13,2590855.90997876,10630067.8712541
1,17,6,0,2,2,10,2208033.78272009,8678191.59879588
1,27,4,2,0,6,12,1874167.8062694,9106259.40132403
0,22,2,2,0,1,5,1525028.6688143,5525525.62375379
0,28,3,2,1,1,7,1826023.68459432,5735995.16185392
0,33,5,1,2,2,10,1293566.38734612,5561171.50743993
0,17,1,2,0,4,7,1147412.74353191,3271075.18444341
0,30,4,0,0,4,8,1648660.83740111,823828.899758168
0,21,0,1,0,6,7,1579236.36522909,4547088.99866753
0,35,4,2,1,2,9,1538896.65496231,4699598.38449536
0,16,6,3,1,1,11,1784135.8155194,5170703.79765067
0,39,3,2,0,4,9,1866601.40721261,4118787.2611808
0,35,6,3,1,3,13,2483353.68715848,7883149.15680408
0,14,4,2,0,6,12,2300055.07668568,7957285.77748517
0,10,5,1,2,2,10,2266674.37001201,4344167.60571965
0,37,6,3,1,3,13,1966200.7526708,9101362.32260802
0,31,4,1,1,3,9,1951184.04435504,6821228.76982105
0,39,5,3,2,7,17,2473206.8675839,8348556.25900334
0,27,5,2,0,5,12,2402248.98781489,4612850.35733087
0,12,3,0,2,6,11,2428279.53687854,5214249.70158594
0,30,1,2,1,1,5,2228662.59993431,1292277.32389978
0,37,3,3,1,5,12,2071094.02619437,5925840.23425403
1,38,3,2,0,1,6,1603074.17968103,5821065.67127013
0,23,1,2,0,3,6,934374.492287593,4756954.41631634
0,21,0,1,1,7,9,1990739.11532636,5859122.98900561
0,32,3,0,2,5,10,2291237.44010691,6828705.00581176
1,17,6,0,2,3,11,2837149.53043354,8169486.36509648
0,25,5,0,1,7,13,2733051.81557015,7993608.99492123
0,36,0,1,0,1,2,1307616.19042716,4181864.63766272
0,39,3,2,1,3,9,1819970.75965426,7851213.7805244
0,12,1,1,0,1,3,1416238.084194,3337496.21397941
0,20,0,2,0,4,6,2167993.47235078,3107783.79750207
0,29,6,1,0,2,9,1725988.49157333,5084307.69836068
1,40,5,1,1,3,10,1796069.87835482,5497670.98418273
1,29,3,0,0,5,8,1872848.64236311,5322903.92453378
0,10,6,1,1,3,11,2249443.52635298,4339752.93354925
1,17,6,2,1,2,11,2200681.42544791,5994285.68496371
1,11,1,0,0,0,1,1250668.23232801,3478927.29679276
1,12,2,0,1,5,8,1906203.66958414,5698062.55811948
0,24,0,0,0,6,6,1300527.34966278,8410508.31457601
0,17,1,0,0,6,7,1263258.48904729,4721915.983398
0,13,3,2,1,3,9,1298831.22571145,7001009.64849424
1,12,1,2,0,5,8,1664332.10493213,4526280.72176368
0,40,0,1,2,1,4,1273734.34490864,4763634.88941826
0,21,1,0,1,7,9,1895146.80819004,4346867.33688063
1,35,6,1,1,7,15,1720371.29738396,3156548.98763564
1,18,6,1,0,5,12,2174954.53131939,10349198.7505649
1,17,5,1,2,2,10,1625705.77655099,5407473.38356294
0,22,3,0,0,5,8,1695808.59736559,8199173.532444
0,16,1,1,0,4,6,1562529.3944883,1671328.4069965
0,28,4,1,2,0,7,1786802.99925128,5925194.28504633
0,21,6,2,2,3,13,2994587.74205809,7130396.52268592
0,27,1,1,1,1,4,1393000.98599514,4563654.18512127
1,29,3,2,0,1,6,1587727.92429969,3087071.78264063
0,20,1,2,0,6,9,2231113.58855885,6354755.68128556
1,15,4,1,0,0,5,1507222.94367062,2896672.97987419
0,17,3,2,2,5,12,2224180.95544159,9081434.52526972
0,12,0,3,0,3,6,1547799.54649265,4081210.23168577
0,39,5,3,0,7,15,2092688.90719638,9288879.86093991
1,25,3,3,2,6,14,2373780.90462255,6968075.33688924
0,13,5,2,0,5,12,1874838.48783412,4798736.80328979
0,20,2,0,1,4,7,2065197.92825019,4921991.56181147
0,40,1,3,0,1,5,1321613.0634489,4406493.26578699
1,29,1,2,0,7,10,2447104.54648981,5115809.39657426
1,10,2,0,2,7,11,1940087.8794464,5770977.07086373
0,23,3,1,2,2,8,2158948.08035837,7618259.00095112
1,29,6,0,1,1,8,1407628.3555534,5876241.49758506
0,30,4,1,0,5,10,2149070.49375209,3390436.58960234
0,26,3,2,0,5,10,2340042.16111485,5448323.13060774
0,35,5,3,0,1,9,1810239.3154376,3865973.22292641
0,17,4,2,0,1,7,1351987.2070096,6330254.88572922
0,24,6,2,0,7,15,2765490.36428476,9547546.72241286
0,19,6,3,1,0,10,1794908.99035872,9958483.78943391
0,25,1,1,0,1,3,1298678.33076372,3700705.25191395
0,36,0,3,1,6,10,2054915.38013245,4708275.2705627
0,31,1,0,2,1,4,1202260.32622593,4814327.58202306
0,15,5,3,1,2,11,1993580.36627023,4859219.23627422
1,24,1,3,0,6,10,2007643.8767666,5001873.65211173
0,26,0,0,0,5,5,1796036.13248726,5886336.18933139
0,15,0,2,2,0,4,1302706.67297749,4496861.39826278
1,29,4,1,1,4,10,1433982.42784143,8923786.18199652
0,28,3,0,0,1,4,1211600.32040247,6575606.54408375
1,37,6,3,2,7,18,3002264.88556598,6753036.11289639
0,10,2,0,0,7,9,2380914.09947445,4303180.98727691
1,30,4,1,1,6,12,2390419.25579545,5289795.4384231
0,39,0,2,1,1,4,1432185.74630803,2454247.99592132
0,25,1,0,0,0,1,1356293.44787267,4418194.8882179
0,31,1,1,0,0,2,1431947.29665167,3008157.37544314
0,14,6,2,0,6,14,2504749.6792781,9760742.64028145
1,39,4,1,0,1,6,1597991.79779257,3867831.50003691
1,15,2,1,2,2,7,1587830.29615322,4482933.61919179
1,39,5,1,2,3,11,2084513.03416364,3271185.31443941
0,23,0,1,1,6,8,1242783.35673545,6153349.44522088
1,21,3,3,2,7,15,2817757.53353259,6427247.87520122
0,38,5,2,1,6,14,2767457.93227951,4634255.06644359
0,14,0,3,1,7,11,1986072.479124,4347435.10856562
0,22,0,1,1,1,3,1256643.48172663,3011049.84880413
0,37,1,3,1,0,5,1489734.2229813,4904391.27115067
1,15,5,0,1,5,11,1977866.69572364,3798673.98241858
0,30,3,3,1,6,13,1915526.24320363,9414768.49682736
1,34,2,0,0,7,9,1480629.63260666,5681922.57213543
0,21,0,0,0,6,6,1380076.6623586,2412332.8505275
0,30,2,0,2,2,6,1505106.48365468,3711905.056198
0,11,6,3,2,5,16,2783151.22721502,9091247.92509798
0,21,0,0,2,5,7,1734429.1267931,4037897.72538247
0,29,2,2,0,4,8,1583699.76777161,5787149.78198636
0,33,1,1,1,1,4,1090301.30984017,4800978.72743543
0,14,4,0,2,3,9,1815255.30146525,3821475.13205461
1,18,2,0,1,5,8,1788860.24095726,4073519.51151922
0,35,1,3,2,1,7,1823510.08558181,5440705.67454292
0,26,5,2,2,3,12,1988096.55730844,4814090.61040952
0,25,6,1,2,3,12,2231562.71318417,6914325.65364988
1,33,6,0,1,1,8,1586636.38582092,6825573.01401824
0,31,2,3,1,0,6,1923607.35896273,4207277.80544054
0,11,5,1,1,4,11,2493083.60873329,5640588.0229075
1,36,0,2,2,7,11,2056968.25969875,2371423.75086033
1,31,1,3,1,6,11,2508921.61585402,6736917.24140625
0,23,5,3,1,0,9,2095615.83467711,3888709.04634724
1,25,3,1,1,3,8,1607643.73913612,2785683.76929971
0,33,4,1,2,7,14,2261694.04904767,4264479.00942929
0,25,5,2,1,4,12,2174921.79441856,5468835.2666952
1,40,4,3,1,7,15,2539457.57668742,4515191.82221737
0,39,6,1,0,1,8,2363444.49309165,6938314.30005107
0,13,0,3,0,2,5,1353455.24191748,4550477.00296949
0,14,3,1,0,3,7,1256224.27860241,4439491.61569162
0,16,0,3,1,4,8,1719109.40383515,2648092.06586172
0,36,2,0,0,5,7,1843815.34742415,3992331.67193384
0,26,5,0,1,1,7,2113558.21321013,4418663.68170763
0,16,0,1,1,3,5,1606288.17987004,6655108.28724513
0,34,2,2,2,2,8,1204719.09587623,4554314.17440096
0,17,2,3,2,3,10,1497799.66533676,6539436.57709076
0,30,4,0,0,0,4,1323956.12537341,2610824.52427128
1,18,3,0,1,6,10,1409178.44281078,7250281.99046299
1,33,6,2,2,3,13,2273997.5609239,7623455.41487867
1,24,5,1,0,3,9,2103550.00646136,6324381.41122797
0,31,2,1,2,0,5,1219604.25837961,2450663.20775693
0,35,1,3,1,0,5,1498872.83404022,3839588.4225978
0,35,2,3,2,7,14,2561196.57453022,5267617.89902175
0,18,1,1,0,4,6,1842767.17284284,4159442.8696559
0,17,1,2,2,5,10,2222276.52494182,5861480.52291813
0,11,3,0,0,3,6,1684832.57723156,5536130.04199179
0,17,2,0,2,1,5,1544603.10341231,5491851.92684571
0,26,3,1,2,4,10,2084894.68788149,9470226.46518229
0,11,0,0,1,3,4,1462269.6691886,5604771.72786589
0,10,1,2,0,7,10,1769972.39389136,4316390.33352781
0,26,4,3,0,3,10,2073126.19570206,7664217.92206919
1,15,0,2,0,2,4,1516133.37883269,3140346.60468565
0,22,2,0,2,7,11,2004974.19726486,9222831.07842727
0,35,2,1,1,7,11,1894425.77943428,7932262.65416011
0,30,5,1,2,1,9,2438138.74211508,5964230.92959688
0,38,1,1,0,6,8,1400640.80982637,5107961.0313435
0,23,4,2,1,4,11,1930334.07857182,2644328.72268252
0,23,6,0,0,5,11,2650685.01774612,3578422.61100523
0,28,6,0,2,7,15,3243419.76098669,12182375.4802613
0,29,5,1,1,3,10,1719536.49185181,7591478.52710747
0,31,5,2,2,4,13,1846498.67096316,8602681.87205563
0,36,6,1,2,7,16,2688150.07367329,10815607.9749408
0,40,1,0,0,2,3,1210644.77804444,4034981.18877067
1,40,2,0,2,3,7,1787597.90906473,5794730.47402659
0,19,0,1,0,1,2,1343680.49295027,4359715.80645576
0,15,0,3,2,4,9,1934629.4883673,6033905.80077725
1,25,1,2,1,6,10,1416170.71684527,3594554.60407843
0,20,2,3,2,5,12,2392852.27866937,4124350.88422854
0,11,5,3,2,1,11,2090503.13760045,3445009.33229807
0,34,0,0,1,4,5,1391941.57287197,2430282.95521579
1,14,0,3,1,6,10,1523064.91882949,5472723.21707557
0,21,4,1,1,2,8,1664348.85670604,6317369.3449424
0,14,1,1,1,0,3,1107923.73406492,4633964.86914814
0,40,4,2,0,3,9,1404811.59197267,7218030.26441403
0,38,4,3,2,0,9,1656508.58705416,7083122.55861733
0,33,6,2,1,2,11,2541409.54783885,5092475.10466716
0,16,2,0,0,3,5,1611059.57185369,3190929.37677343
0,34,4,0,0,0,4,1564714.64214286,1761505.92939905
0,18,4,1,0,0,5,1427986.33144306,4736230.79441083
0,37,6,3,2,7,18,1665556.83535807,6325155.10432969
0,16,1,1,2,7,11,1185039.97154364,8071445.34245439
1,16,3,2,2,7,14,1188615.09985045,7801923.77315415
0,31,0,1,2,7,10,2521848.22378542,7520473.37698794
0,27,1,3,1,4,9,2084605.14408882,3706762.83642633
1,11,5,1,1,7,14,2262873.47600563,11596740.0520666
0,18,6,1,0,2,9,2010686.50735235,5512500.14006323
0,36,4,2,1,7,14,2062048.04883527,6756211.41730308
0,15,1,3,0,5,9,1797313.765816,6262823.6837461
1,29,5,2,0,1,8,2242836.47509121,4693534.03065362
0,22,5,2,1,1,9,1944770.94239137,5686543.44610397
0,15,0,1,2,0,3,1518304.48343819,4376872.2540011
0,11,3,2,0,4,9,1805718.63073056,6704635.9529234
0,13,2,0,1,3,6,1090670.17059661,4504453.34175476
1,20,0,0,2,2,4,1326995.36854158,5648569.19059011
0,25,3,2,1,3,9,1742060.3538309,7992925.94040542
0,12,6,1,1,1,9,1461047.00735941,7006956.58248418
1,22,2,1,2,7,12,1394193.30269176,6082994.92065986
0,32,2,2,0,4,8,1924409.25098826,8106773.69597847
0,36,3,2,1,0,6,1936815.37666157,5516754.46239697
1,31,4,3,0,7,14,2600129.27769087,11712072.4094619
0,33,0,1,1,4,6,1648457.44347402,2683537.93218177
1,27,4,3,1,3,11,1917217.4877766,7815828.48992304
0,12,0,3,0,5,8,1651340.46105279,6613276.12692755
0,11,0,2,0,5,7,2155498.34075959,5576211.19427984
1,21,6,0,0,3,9,1484844.05271507,5412908.64394884
0,32,6,2,1,3,12,2406451.89296477,6774315.75170865
0,24,6,0,2,6,14,2980060.13591639,8089705.69759764
0,18,3,2,0,2,7,2205133.01772316,3685286.2013761
0,18,4,0,2,2,8,1577354.93297084,4281204.63182581
1,19,5,2,1,6,14,2695105.58753794,8448218.63623569
0,16,6,0,0,5,11,1881243.84740496,7407465.48423808
0,36,1,3,0,3,7,1134989.57758576,5831485.9610199
1,18,1,2,1,5,9,1383140.84538305,6924471.91465373
0,15,5,3,2,1,11,2525871.08663971,5121976.25482838
0,38,3,2,0,5,10,2456161.95654574,2747754.37734318
0,26,5,2,1,6,14,2840085.30918894,8690507.78345923
0,34,3,1,2,6,12,2326308.49499657,7218396.0733799
1,37,1,0,0,2,3,1258489.59446303,4129009.24839835
0,38,5,0,0,3,8,2286070.60643293,4947339.69340481
0,10,6,0,0,0,6,1968697.50349255,5747744.34555661
0,34,6,3,1,5,15,3144623.6574273,12560084.6166132
0,27,2,3,0,6,11,2198241.09433821,7600437.69089694
1,36,6,3,0,1,10,2462763.35151805,6421455.87208533
0,20,3,3,1,6,13,1542821.13598486,5389178.85100498
1,15,2,3,2,1,8,1718048.2059003,1955456.38964366
1,17,5,2,2,5,14,2203589.30863184,7592445.14707291
1,39,6,3,2,3,14,1699461.34252012,8046470.2131372
0,21,3,3,0,4,10,2018138.91325701,7786985.04854432
0,39,3,1,0,5,9,2083929.03426035,7397798.99336402
1,25,4,3,1,0,8,2034037.13856463,4912198.5510844
0,19,4,1,0,3,8,1601296.42358941,10196181.5963386
0,10,5,2,2,6,15,2621078.79847314,7711086.13138981
0,39,1,3,1,4,9,1646632.90920188,4731488.08451117
0,32,3,1,0,1,5,1581055.56610491,7721296.51257727
0,11,4,0,1,0,5,1339242.84189286,3883844.35912034
1,24,2,2,1,2,7,2056600.04396739,5091661.77503802
0,31,6,0,1,5,12,2091063.38256533,4090417.70160445
1,32,6,2,0,7,15,2586857.00689369,9377060.31319738
0,11,4,1,0,0,5,1618099.8286315,4188865.01299392
1,27,5,1,2,4,12,1807756.37192107,9746564.94855219
0,38,2,3,0,7,12,2360481.91318945,3273744.09748445
0,20,5,1,2,5,13,2275353.61842448,7785701.45829744
0,11,3,2,0,3,8,1178828.59836571,3037591.32321594
1,21,5,3,0,7,15,2823435.17910249,4430162.69303613
1,11,3,2,2,1,8,1471027.43267964,5378746.48741469
0,31,0,1,0,5,6,1396427.22497865,7370554.80136235
0,32,0,0,0,0,0,1181934.84419878,3392430.31644126
0,32,2,0,0,7,9,1933549.49513561,1854657.64635588
0,10,4,1,0,7,12,2774154.33076563,6119471.29961604
0,16,0,1,2,0,3,1358072.65783223,4616806.56204291
0,27,6,1,2,1,10,2081954.99145211,8441273.0008158
0,17,2,1,1,2,6,1581692.01389796,5754523.04467175
1,33,6,0,1,7,14,1813459.54647254,5800570.77404316
1,10,1,2,2,4,9,1611511.20297815,6025279.9766068
0,21,1,2,2,3,8,1892414.26160931,4136664.22721978
0,11,4,3,1,5,13,1483348.86721944,5213938.43399532
0,26,0,3,1,6,10,1823492.69813084,4999965.09017252
0,39,0,3,1,5,9,1562709.17623793,7461570.64140427
0,16,6,1,2,2,11,1954885.19588763,7596246.36101121
0,34,3,0,0,6,9,2486173.94922265,3701369.8162285
1,33,4,2,0,3,9,1842614.69997231,5392598.63751304
0,11,4,1,0,1,6,1459354.24579673,4446378.86982871
0,15,5,3,0,4,12,2199615.18524637,6480286.02020558
0,11,4,3,1,3,11,2268754.549442,6929651.02233065
0,18,4,1,1,1,7,1467982.14042983,5492721.44510349
0,30,1,2,1,6,10,2167323.80418795,8898381.43868727
0,37,1,3,2,0,6,1444199.30559108,2067113.19401493
0,37,2,3,0,3,8,2067320.13203705,4863151.87109959
1,15,5,1,0,4,10,1969601.56924497,4651233.90515287
0,12,2,2,2,2,8,1992261.28953694,3882113.02937531
0,29,1,1,2,1,5,1737146.87951705,6613291.79525533
0,32,4,0,0,5,9,1872270.25693027,3245112.43904642
0,33,6,0,2,1,9,1977160.80699166,6174818.24598677
0,26,6,0,2,3,11,1637724.01371918,5466271.02637023
0,20,0,3,1,6,10,1757847.54929242,7576433.306144
1,11,5,1,0,0,6,1592139.28578048,6431286.48873316
0,12,1,2,1,7,11,1912068.61072781,9409661.30571849
1,11,1,2,0,1,4,1301379.12895639,5129075.06109115
0,34,5,1,0,4,10,1771531.77942783,6635030.57038581
0,23,0,3,1,6,10,2320059.55101475,6411520.28464061
0,26,2,1,2,4,9,1577082.62963494,5518575.48770891
0,31,2,1,1,1,5,1646738.70446693,6197072.66659395
0,36,6,3,1,7,17,3555633.79137669,6503354.06852552
0,13,3,0,2,1,6,1326362.02631204,2984450.6017738
1,22,1,0,1,0,2,1331879.90471866,4335943.02898175
0,34,1,1,1,4,7,1755901.9163455,3045925.61220684
0,12,3,2,1,5,11,1949262.60393034,7361137.11679214
0,39,3,1,1,3,8,2015375.32607177,4146021.3298038
0,28,1,0,1,6,8,1775205.46717985,5059801.90642315
0,23,1,3,2,4,10,2468673.43523375,6844692.20775902
0,18,0,0,0,7,7,1711640.14615758,5924473.13904335
1,34,3,0,0,2,5,1790310.38021424,5028347.0418522
0,12,2,1,2,7,12,2083361.01660671,5523192.93371859
0,40,0,1,2,5,8,1975183.46527271,6720633.52512166
0,37,3,2,1,0,6,1675843.91419781,2810942.01201068
0,20,5,0,2,6,13,2218059.75115285,2376842.67587693
1,35,4,0,0,1,5,1779280.27706589,6400424.36589059
1,28,3,2,2,0,7,881852.215140281,3161990.61603439
0,28,6,3,1,6,16,3000168.15066323,3500831.46078984
0,26,0,3,2,5,10,1878675.4394948,6939223.66915623
1,23,4,2,1,1,8,2093855.89078527,6775321.97161462
0,38,3,1,2,0,6,1612248.51883648,5348582.09816364
0,32,4,2,0,6,12,1550578.59718571,7179653.18052743
0,29,0,0,2,0,2,1342264.94081633,4706004.96606301
1,38,2,2,0,5,9,1702169.66821628,5950869.7600628
0,23,2,1,1,3,7,1791240.59026759,6270654.01458443
0,13,3,2,0,1,6,1398156.04224138,4281525.29234746
0,24,5,3,0,0,8,2136923.45987201,5646388.35705992
0,11,0,2,1,6,9,1939715.97806359,7738865.11799001
0,23,1,1,0,7,9,1562252.54214446,7280121.83682572
1,18,1,3,1,1,6,1697813.9750718,6433635.20011525
0,20,2,3,0,6,11,1762047.05095516,5642007.90925779
0,14,0,0,0,2,2,750701.541844062,6180575.74610901
0,28,1,0,2,0,3,1302941.38974035,4524753.29556771
1,22,6,0,2,4,12,1813279.17930793,6704050.69124447
1,16,5,2,1,2,10,2576592.67623918,6649657.16610341
1,22,4,0,1,0,5,1894195.16539126,3857830.71297617
0,38,0,1,2,6,9,2282775.24406497,7931922.69085418
1,16,0,3,0,5,8,1590412.90297323,7325007.99227593
0,37,5,3,1,4,13,2256650.17256014,7196011.65429016
1,22,1,0,2,5,8,1912479.49941222,4377500.26282337
1,27,5,0,1,4,10,1638608.61679879,5187467.94287654
0,35,3,1,2,2,8,1807849.90014512,6211401.38914341
1,22,3,1,0,3,7,1187486.49789917,4009903.99567712
0,35,4,1,1,5,11,1971314.54180182,6860557.19165584
0,30,3,1,2,0,6,1221657.6424314,3246850.91143584
0,22,4,2,0,0,6,1474614.34726469,2418557.53314204
1,35,2,1,1,5,9,1779114.1094275,7648769.67816481
0,11,4,0,2,2,8,2227138.66808907,6576980.32447826
0,22,3,1,1,1,6,1661972.93808595,4828044.68319794
1,30,5,0,2,4,11,1847207.79790741,5591109.96897429
1,31,4,0,0,6,10,2194028.25933863,6166868.45033671
0,14,5,1,0,6,12,1687938.20994842,6393461.72881878
0,36,2,0,2,2,6,1878483.08654549,4968053.56268749
1,32,2,2,1,0,5,1569500.61207216,4154337.70284503
0,16,5,3,0,2,10,2022762.69005974,4916451.57532402
0,40,3,2,0,0,5,1694342.27762363,5383986.05593603
0,28,0,1,0,2,3,1341547.55867723,2696885.96272612
0,11,5,2,2,2,11,1830310.30110679,8400568.12225605
1,23,6,1,2,2,11,1976317.79490863,4821253.82643779
0,27,4,0,2,2,8,2478189.67120026,6695245.04206251
0,34,5,3,0,0,8,1472659.6159319,3503429.73026562
1,37,5,3,0,0,8,1803369.2520515,6743785.0105165
0,17,2,3,1,6,12,2278631.48053531,7868365.68881167
0,33,6,1,2,3,12,2263155.23024326,5480999.36222508
0,40,5,1,0,3,9,2309935.15284303,5446430.11443327
1,25,0,1,1,7,9,1574733.80559174,5600612.34258809
0,25,5,3,2,2,12,2137461.09285529,6954588.46340873
0,18,3,2,2,3,10,1936005.55770188,4194395.14788963
1,15,2,1,0,0,3,1163709.84067,4700895.54912918
0,13,6,0,0,3,9,1633630.94928517,3097867.32507107
0,12,0,3,1,0,4,1741232.12920666,3675935.40964418
0,39,4,1,2,2,9,2451920.82736242,5402572.79432756
0,35,3,0,2,6,11,2106052.37502121,5236408.36786264
1,31,3,0,1,2,6,1721018.47441527,5369362.89666893
0,28,6,2,0,4,12,2148406.92299968,2659925.60997393
0,15,3,2,0,2,7,1848365.2918305,3564813.80153247
0,30,0,3,2,7,12,2219627.35282444,4376804.89458877
1,23,1,1,1,2,5,1813509.8499681,4337598.48255934
0,20,3,1,1,0,5,1304766.44790644,6759099.11088633
0,24,4,0,1,0,5,1349166.44832952,2691997.78859745
1,31,4,1,2,4,11,2161991.26649985,6751206.47174794
0,37,4,1,2,2,9,1735689.00310316,4979067.36033935
0,12,0,3,0,6,9,2142949.68482548,3721966.80228032
0,32,6,0,1,7,14,1761458.91908331,12237673.4916601
0,36,5,0,0,5,10,1825415.01148303,8013248.57199016
1,11,4,2,0,5,11,1867949.38979218,5466032.45041352
0,40,2,2,1,1,6,1466602.31013462,2510800.85422672
0,23,4,2,2,7,15,2497325.46765068,10268999.7647985
1,38,4,0,0,4,8,1790917.26743707,5142474.78173891
0,25,4,2,2,7,15,1535669.85039282,7675847.31702054
0,32,5,3,2,4,14,2809266.23657145,7502157.23526383
1,26,0,2,2,2,6,1799764.37293633,3271150.90730742
0,34,1,3,0,4,8,1903352.10229071,7701280.54833649
1,27,0,1,2,0,3,1020949.36832161,3732223.11516351
0,12,4,1,0,2,7,1596509.86257292,6636978.28303382
0,30,2,0,0,3,5,1468517.49565521,4336406.46623474
1,17,4,0,1,4,9,1712380.40991148,6196320.71450754
1,23,6,0,0,0,6,1679534.51944558,5443479.94962424
1,10,3,2,0,0,5,1539369.4639596,3964380.31532453
0,27,6,1,2,0,9,1910121.01716045,7737881.49301044
0,38,6,3,2,0,11,1765001.94235603,5067514.87658244
0,22,5,0,0,2,7,1322383.93081591,4177277.75091179
1,26,1,1,2,1,5,1547962.85837354,5955498.84856052
0,36,3,0,0,0,3,1513472.13490276,563892.3636795
1,38,3,3,1,7,14,2653901.87312779,5893387.67604999
0,14,4,3,1,0,8,2153333.9288364,8528565.90629676
0,35,6,2,1,3,12,1918171.5766207,4852413.4614287
1,25,2,1,0,6,9,1772825.11774035,4137547.65954308
1,25,5,0,0,3,8,1823519.00438103,3870643.32116247
0,39,6,0,0,3,9,1523889.40887627,4541584.56121712
1,14,2,1,1,7,11,2319285.59046088,6455486.82939217
1,24,2,2,0,0,4,1603234.36327266,3374113.27644578
0,27,0,2,2,4,8,2009220.72698568,6853165.84383475
1,40,3,3,0,5,11,3016139.92542163,2113648.3095101
0,40,1,1,2,6,10,2089127.14397373,4678727.58618974
0,38,2,0,1,6,9,2076933.55795591,6643282.76413663
0,22,1,0,2,2,5,1565856.80371542,5667359.02778127
0,37,3,3,2,0,8,1987476.63162099,3327240.98730705
1,14,2,2,0,2,6,1530279.50926513,8175836.3695399
1,12,5,2,2,6,15,2168468.1438732,10790352.1815217
0,18,4,1,2,7,14,1980235.09600236,8039182.78152537
0,22,0,0,0,3,3,1515472.46095422,1770136.6975455
0,33,3,1,1,5,10,1960741.44941178,8157408.61113628
0,30,0,3,2,5,10,1645041.28435309,7612034.27813443
0,19,2,2,1,0,5,1631489.34407848,1605478.23366903
0,29,6,1,0,1,8,2086471.92349458,5612748.74498293
0,22,0,2,2,7,11,2294371.1417223,8719601.11160003
0,33,0,3,2,1,6,1336354.77107792,6183122.34110158
0,26,5,2,2,0,9,1574282.52176452,3999407.6023084
0,11,1,2,2,0,5,1377447.70777801,2995967.03972369
1,28,6,1,1,0,8,1955278.36545355,1763633.7025681
1,36,1,2,2,4,9,2421723.56905332,7718885.97612298
0,28,2,3,2,6,13,1878070.91440122,7088350.04992893
0,12,6,3,2,1,12,1778974.23640037,5151114.24268806
1,36,0,0,2,2,4,1912156.96290215,2659501.6105739
0,31,2,2,1,7,12,2205093.78536009,7638573.03432291
0,30,2,1,1,6,10,2007547.28595098,6410069.12433258
1,22,3,2,0,4,9,1900722.25382497,4374390.77599744
0,16,0,1,1,1,3,1521695.87591542,3993086.73653743
0,10,5,3,2,5,15,2192154.27734871,7642447.18393545
0,15,3,1,2,1,7,1987251.76179061,6496465.11129334
0,29,5,0,2,6,13,3125256.2655932,5384425.81721918
0,23,4,1,1,4,10,2406470.02220517,3433704.12610889
0,11,2,2,2,7,13,2060084.98690005,4059287.04271708
0,37,4,2,2,4,12,1841735.73165641,8481241.16082665
0,40,4,0,2,2,8,1533799.23379079,2912934.53445001
1,34,5,0,2,2,9,1801976.54118904,2821365.44523753
0,10,2,1,1,3,7,1749665.40287,3222750.13842525
0,18,0,1,2,1,4,1082528.46410001,5375131.8935455
0,19,3,2,2,2,9,2083029.18281256,6973107.79126983
1,36,2,0,0,2,4,1543353.09229877,5245046.97887418
1,35,0,3,2,7,12,2322762.14262355,6648545.32692379
0,23,2,0,0,7,9,1836444.51547828,3991460.26128451
1,33,3,0,2,2,7,1738238.75722989,6604722.77199712
0,13,6,2,1,5,14,2260888.7237365,6570626.90074642
0,31,5,3,2,7,17,3155560.81335831,6850885.36354828
1,22,3,0,0,2,5,1676052.74739275,4651361.08411654
0,36,2,0,1,6,9,1730324.42399712,4530379.70223625
1,19,2,1,2,5,10,2078139.86527589,6326635.42867371
1,27,3,0,2,2,7,1872177.52368126,2916978.60292675
0,37,1,3,0,3,7,1245293.78549165,4312680.5972496
0,10,0,3,2,3,8,1845228.43766128,6299328.78462098
0,32,6,3,0,3,12,2617607.23541268,8564221.59025426
0,21,1,0,1,1,3,1499421.2326148,3291680.96041634
0,30,2,0,1,7,10,1871057.45949609,7926353.48054222
0,35,6,0,0,0,6,1485937.35078366,4011030.39529035
0,16,4,3,2,1,10,2099066.72870183,7847714.59706213
1,30,6,1,2,1,10,1969315.7516149,5646846.15563725
0,30,5,3,1,0,9,1559312.43721781,2212143.9374015
0,28,1,3,1,3,8,1489014.92823898,5727331.89475493
0,10,6,2,2,1,11,2413881.22936774,2809098.38350694
0,37,2,0,1,1,4,1526454.76653455,6912288.57114578
0,13,5,0,2,0,7,1680927.11124383,4772918.66843425
0,24,1,0,1,0,2,1280599.75407411,3382056.19917195
1,32,2,3,0,6,11,2102675.21331082,6416707.33962412
0,19,1,0,0,5,6,2179169.32186336,3823468.33559395
0,23,5,0,1,2,8,1635068.45670007,5635132.0992334
1,16,0,3,1,3,7,2190991.54434918,6992111.94274603
0,10,4,3,1,3,11,2281575.12291692,7031194.9902814
0,14,5,0,2,1,8,2049065.64356407,4250519.76234789
1,38,2,1,1,6,10,1805010.34449583,8961615.22876658
1,37,6,1,1,1,9,2139453.35138428,6907438.96798729
0,12,2,2,1,7,12,1682000.0573867,4659324.74914586
0,37,2,1,1,4,8,2109335.6735837,6247949.41873389
0,36,0,3,2,1,6,1211948.95154625,3619987.63275831
0,13,4,3,1,3,11,2376088.38454984,6206188.4297972
0,34,3,2,1,2,8,1275248.78499359,3885217.2238591
0,10,5,1,2,0,8,1699630.16785664,5861004.9484641
0,10,0,1,2,4,7,1518609.99705114,5696628.98106707
1,32,0,0,2,7,9,1997219.42113275,6311981.45952802
0,20,3,0,0,1,4,1534956.26049747,2663839.45999274
1,19,4,0,1,3,8,2157802.62227993,3761820.65622309
1,14,3,1,0,7,11,2921942.29665814,3890931.51615067
0,27,3,3,2,3,11,2204492.65650831,7327061.38676585
1,17,4,0,2,2,8,2289985.02643301,3622471.00621525
1,30,6,2,0,5,13,2126428.09717565,7035957.75876617
1,20,4,3,0,2,9,1731540.90907981,6899866.87099313
1,31,2,3,0,2,7,1592339.9188255,7320558.14483901
0,29,6,1,1,2,10,2129622.7463662,8371875.54191534
0,15,0,3,0,6,9,1922941.19801532,6220661.63559528
0,19,2,3,1,2,8,1438110.36925996,6683862.92778771
0,33,2,1,1,3,7,1874436.9873993,3297958.9080855
0,36,0,1,2,0,3,1623892.08010262,2842717.7844477
0,14,2,2,1,7,12,2528719.12528853,5822204.82174041
0,13,0,3,0,4,7,1738413.7620506,6601906.86202757
0,27,4,1,2,4,11,2132493.50810446,6386994.70365845
0,39,4,3,1,3,11,2065118.36765275,3580667.61091708
0,14,5,1,2,3,11,2292148.27442251,6243047.97096298
0,17,5,0,1,2,8,2079733.63150137,6126597.40543687
0,29,6,3,0,0,9,1489286.22113438,3810084.39452389
0,10,1,0,0,7,8,2008621.07740866,6155884.74684173
0,12,0,3,0,1,4,1110032.18903176,2466271.34050763
1,15,2,3,1,6,12,2293727.74222115,5196828.44214431
0,23,2,2,0,7,11,2356998.35947758,8507602.09274708
0,16,0,2,2,4,8,2011739.46334821,6331786.5423655
0,27,6,1,0,7,14,2813375.05645909,5859317.14871232
1,10,1,1,2,6,10,2386125.06693682,8707538.28670294
0,12,6,3,0,3,12,2344888.97130219,3963737.23264647
1,34,1,0,2,3,6,1781726.90937031,4794387.9825811
1,10,6,2,0,4,12,1788029.49371621,8926949.3595933
0,34,0,1,1,2,4,1547104.81686515,3893136.47446381
1,18,3,0,2,0,5,1750372.05563603,2902072.1097486
0,16,0,3,1,7,11,1862427.62095649,7944625.32166351
0,30,2,2,1,3,8,1426176.77667743,4930524.47963973
0,33,5,0,0,1,6,1484503.08263548,4010831.23475471
0,10,0,1,2,6,9,1722989.14386023,454727.745185695
1,39,6,1,2,7,16,2157901.90371639,6176249.37946376
0,19,2,1,2,7,12,2369141.36094832,8024155.76499716
0,23,5,0,0,1,6,1540280.03621474,6745109.60600909
1,26,1,1,2,3,7,1302933.62081956,3401658.1916777
0,33,5,0,2,7,14,2407924.01348545,10417335.1796593
0,17,5,0,2,6,13,2246547.77272809,6920792.87793132
0,24,0,0,2,5,7,1604586.4257326,4858923.27807315
0,20,5,1,2,1,9,2110067.13160285,6631098.71262412
0,28,3,0,0,0,3,1373810.59506764,4794465.08747078
1,23,3,3,2,6,14,2779229.73104627,9132347.99515457
1,25,5,2,2,7,16,2453236.96900414,6359189.39064398
1,11,4,0,0,5,9,2175410.33086599,5509261.29020738
0,38,5,0,2,1,8,1934464.96391146,7061908.24985152
0,29,0,3,1,7,11,2333518.26408721,6153585.1445384
1,35,4,2,2,6,14,2186392.2034971,4069857.22503513
0,32,6,1,0,1,8,1458954.11382148,5068032.86841615
0,28,6,1,1,2,10,1787199.44090541,5257592.09098949
1,14,0,3,0,2,5,1511023.19582935,5818103.66986804
0,25,2,1,2,0,5,1866104.47006913,1753944.66473532
0,38,0,0,0,5,5,1580016.56798725,6411632.64459284
0,29,4,3,1,0,8,1827231.79074318,5620497.17960775
0,29,4,1,1,3,9,1204593.56163838,4595736.71598046
0,12,2,1,0,6,9,1994657.96798663,4622438.55470834
0,39,1,0,0,7,8,1173622.13062091,3445927.42499484
1,24,4,1,2,7,14,2293526.29053695,9096501.26468596
0,21,3,0,2,0,5,1399019.33072991,5405802.38518574
1,32,5,2,1,0,8,1932191.6837753,8571648.46228323
1,18,3,0,0,3,6,1315207.93034707,454900.208006696
0,19,6,1,2,1,10,1472087.26370642,8491392.22325114
0,17,4,2,0,0,6,1901708.99011191,4705515.57947931
0,33,6,0,2,0,8,1799957.77279009,7326650.16010682
0,28,4,2,0,6,12,1842006.85476119,7179439.69126735
0,37,3,1,1,0,5,1262376.35561202,3748353.86940335
1,30,2,0,2,3,7,975262.588986689,6689327.89015261
0,16,3,0,0,7,10,1724932.4860744,7787047.48766047
0,10,2,1,0,7,10,2343999.51922419,7659602.13977585
0,37,4,1,0,7,12,2068333.85333101,8134503.78986184
0,22,6,1,2,1,10,2196548.33182777,6305409.25896967
0,16,2,3,0,3,8,1942397.39790542,5057604.44115422
0,34,2,3,2,4,11,2727011.75671496,5322085.00038071
0,17,6,0,1,5,12,1386984.79890628,7432810.63641693
0,27,6,0,0,4,10,2288214.96508844,11535666.3612657
1,33,4,2,0,1,7,1933969.71461118,5952452.28677747
0,37,2,2,1,3,8,1896019.39378982,6489735.39715372
0,14,5,1,2,7,15,2410726.97888653,4720515.26417072
0,39,6,2,1,7,16,2376754.06083671,7441244.11999297
1,20,5,0,0,1,6,1127500.41139801,7199234.39648807
0,37,5,3,1,1,10,2062514.4145429,5854726.76459174
1,25,2,3,0,2,7,2194133.17935552,7710294.66202742
0,19,3,2,2,0,7,1910351.587876,4938940.74261563
0,40,5,0,1,3,9,1634731.92779713,5835996.84351099
0,25,1,0,1,4,6,1296282.00352461,4566590.43494103
0,36,4,3,1,4,12,2662851.3300635,6713547.77603403
0,12,1,1,0,7,9,2200970.49116214,5885831.72653467
0,34,5,1,2,3,11,2202019.20209753,4953188.14840656
0,29,2,0,0,5,7,1550850.00041706,5021592.10480307
0,25,4,0,1,3,8,1879989.71800729,4744476.68232136
0,17,0,3,2,4,9,1611313.44017327,5966273.62544143
0,32,0,0,0,5,5,1574486.73979331,4336834.65127748
0,16,0,2,0,2,4,1189133.45492306,2789074.98083618
0,17,0,0,1,5,6,1050376.19072472,6650109.89304482
0,27,3,0,2,2,7,1693778.3617888,5465810.31763102
1,40,3,1,1,3,8,1870641.98829637,5770072.77503275
0,24,0,3,1,4,8,1849998.15924105,6435324.79943796
0,28,1,2,0,6,9,2074091.84057451,5231187.70153275
0,36,4,0,0,3,7,2234032.03407839,3795174.89669259
0,16,0,0,1,3,4,1708436.63852983,4718509.79578404
0,10,4,0,2,3,9,1952266.9251476,7667102.30221756
1,21,3,3,0,7,13,2256534.36718395,9650139.97988129
1,34,2,3,2,1,8,1655609.01136825,8261794.90113855
0,38,6,0,0,2,8,1805315.60330828,1370867.98731591
1,28,2,0,2,7,11,1642943.14124362,6866288.08892062
0,25,6,2,2,1,11,2138419.41897269,5407253.96406595
0,31,2,1,1,3,7,1467523.31005703,5781002.03654099
0,30,0,0,2,3,5,1535255.7315858,2982134.28596532
0,15,6,0,0,2,8,1745868.36589494,4898411.14396362
0,36,0,2,1,3,6,1609730.46700702,3991729.29057176
0,36,5,1,2,6,14,3144675.2376699,7180183.64127195
0,37,0,1,1,2,4,1744154.29391449,3068950.15561737
0,39,5,1,0,5,11,2184448.55941477,6270765.57670243
1,29,1,1,2,4,8,1813389.52605756,5229877.47896139
0,40,0,3,1,3,7,1551704.58627116,5928049.12770257
0,28,1,0,2,5,8,1758440.4558399,6028561.23557614
1,13,0,2,2,1,5,1293901.0246176,2626618.0192629
1,32,5,1,1,3,10,2413824.66187971,8389478.56199027
0,29,2,2,1,5,10,2498256.96806968,4545335.86949377
0,26,2,1,1,3,7,1434584.03898767,4211156.19914308
1,33,1,0,1,0,2,1321702.70267384,3988287.35806591
1,16,5,3,2,0,10,1887049.09153932,3055274.06686778
0,33,4,2,2,1,9,1869080.4115475,7431265.66710879
0,10,5,0,2,4,11,2038745.98301238,5847762.7061561
0,22,1,0,1,7,9,2069336.0725971,5925149.43860043
0,25,3,3,1,3,10,2689504.23579518,7684826.99993537
0,17,4,2,0,3,9,2635787.88621989,9768166.09797902
1,35,1,1,2,7,11,1534042.84088467,3329831.58344837
1,33,2,0,1,7,10,2393093.58219078,4246493.93792175
0,33,0,3,1,6,10,2531254.52658309,6937720.61122132
1,36,5,1,1,5,12,2440083.78345034,7983065.63018183
0,23,5,0,1,0,6,1665296.40014864,4866036.42198223
1,29,5,0,0,4,9,1985325.79282384,6064803.11237959
0,18,3,0,2,1,6,1390583.80003845,2611646.0895727
0,12,2,0,2,3,7,1420182.33342947,6267970.69676495
0,28,4,3,1,7,15,2989439.0577474,7662220.17098578
1,17,6,3,1,5,15,2582620.59310499,7593092.26467086
0,17,0,3,0,5,8,1831104.85693118,6754801.8165393
1,26,4,1,1,5,11,1668095.77860704,6151022.36586978
0,31,6,0,2,0,8,1821948.74308365,7398001.39719796
1,40,5,0,0,0,5,1714819.19131894,4800579.01900206
0,18,5,2,2,1,10,1784746.01881988,5605178.47508984
1,31,6,3,2,5,16,3451261.06874162,7465632.99029006
0,15,6,0,1,3,10,2178013.87580883,7349458.22350533
1,19,4,2,2,7,15,2452625.6476024,8866588.98764101
1,30,5,2,0,6,13,2289150.21046423,8822395.3053431
0,30,6,1,1,3,11,1904607.31519678,6707095.21427293
0,15,5,1,1,2,9,1911872.60396143,5629431.14715877
0,13,0,2,2,1,5,1929567.14604361,4494554.10870246
1,27,3,3,2,7,15,2603653.26518388,5646517.59296186
0,39,1,1,2,0,4,1506200.81166371,6330850.82947861
0,21,5,3,0,7,15,2687381.69105204,5715805.87519564
1,31,0,2,1,1,4,1325980.15313621,6415461.01119808
0,14,4,1,2,6,13,1896963.63296113,7265756.04025628
0,13,6,1,0,7,14,1796524.83763661,8142680.19118377
0,21,4,0,2,7,13,2100570.63403061,4868385.80578204
0,10,2,0,2,6,10,2103216.24656621,8527320.06773749
0,32,6,3,0,6,15,2586172.58970807,7441628.02480685
1,36,4,0,2,4,10,2339984.75304797,3583080.60853338
0,10,2,2,0,2,6,1199722.46057613,6385344.84732602
0,34,2,2,2,5,11,1381461.99999092,4749980.67031701
1,36,3,1,1,2,7,1976872.031373,1446567.43916709
0,20,5,2,1,1,9,1611094.95169672,4562918.05754844
0,27,4,0,0,1,5,1474880.58788673,4466384.66515866
1,33,1,2,1,1,5,1448129.62997072,4325772.61243225
1,21,0,0,1,0,1,994314.986948929,3379721.76379781
0,32,2,1,2,2,7,1649821.64822765,4750473.79753699
0,36,2,1,2,2,7,1031162.30904919,4891109.00238796
1,25,4,1,1,4,10,1877474.80231337,8005695.97715848
0,26,6,0,2,0,8,1962019.77988716,6853428.40066465
0,25,4,0,2,5,11,3061689.35632608,9306370.85706022
0,22,4,0,2,3,9,1774060.37244968,6541440.50233933
0,21,4,0,0,4,8,2128441.33601355,7591087.367085
0,16,4,0,0,1,5,1554638.28136385,3356798.99847293
1,18,3,0,1,6,10,2114435.54951677,5064607.43130699
0,26,0,2,2,1,5,1084544.38159821,6050106.07546263
0,23,0,3,0,2,5,1301433.93991693,4558079.17700272
1,15,2,1,1,3,7,1810829.75403561,5138692.92777183
0,16,0,3,0,1,4,1532218.76368304,2193915.4002741
1,40,5,1,2,0,8,1720798.45080753,4601212.03648161
0,21,0,2,1,2,5,1933307.13591979,7060882.77480461
0,28,2,3,1,3,9,1910398.6786427,8473753.74638968
0,29,2,3,1,0,6,1661131.35394461,5250973.94238739
1,24,5,2,1,6,14,2762549.91558815,6207407.81670238
1,29,5,2,0,7,14,1895106.5200119,7391365.02871348
0,21,1,2,2,0,5,1239050.74397907,6328748.89233145
1,26,5,0,2,5,12,2749478.0752985,6677941.44249341
0,39,3,0,0,3,6,1619157.73144481,4061988.65389213
0,27,1,1,0,0,2,990969.266908008,5136557.97106408
1,34,6,0,0,7,13,2310159.5950912,4188085.14716103
0,23,1,1,1,3,6,1873955.91436596,5182210.9232812
0,32,5,1,2,6,14,3096464.09557512,2824823.11157642
1,23,4,1,0,6,11,1844044.14265571,4019640.78417456
0,31,6,3,2,6,17,2703998.81577286,7743769.69004815
0,35,3,2,1,4,10,2211965.73600352,5666387.86338558
0,39,2,2,1,0,5,1655510.82056066,3762224.98524776
1,18,0,0,1,0,1,1653124.29281214,4391832.19568566
0,20,6,0,2,4,12,2248190.13932032,11240646.1293097
0,34,4,1,1,0,6,1454421.11985775,5514808.9894363
0,28,3,0,0,2,5,1117130.18919497,5249969.82645612
0,31,5,0,2,1,8,2114487.83115276,6284252.08426725
1,40,5,1,2,2,10,1714713.24236884,5025391.88997836
0,14,0,1,1,4,6,1825225.01358123,2834583.60374955
1,21,3,2,1,5,11,2502347.59336704,7440283.41881749
0,26,5,0,0,3,8,1992134.4837071,4255117.56577525
0,25,4,0,1,6,11,1396122.5160153,7586644.82101639
0,32,6,3,2,0,11,2799070.08167519,4793322.33949075
1,14,0,2,2,4,8,1529514.37230992,4385046.86214733
1,35,6,2,1,2,11,2429491.02225288,8253238.00406623
0,28,4,2,1,1,8,2452377.46491517,8865690.73621788
0,13,0,1,2,0,3,1573318.52076743,2660790.43563628
0,29,5,0,0,1,6,1558469.36412982,4037989.24472477
0,29,1,2,2,2,7,2087494.90570049,6210389.7777094
0,21,0,1,1,1,3,1398315.99924611,3108168.09885491
0,17,2,3,2,2,9,2394771.38727381,2329418.93328606
0,40,2,2,1,5,10,2263506.55577656,7444373.55677553
1,29,4,0,0,7,11,1977928.47916918,7857935.41203295
0,39,1,2,1,2,6,1334673.71685624,7157251.76211964
1,14,6,0,0,0,6,1562742.80783306,5818902.75810511
1,38,0,1,1,4,6,1500861.95018918,5648875.19935882
1,29,6,0,2,0,8,1936498.49873451,3559275.2081381
1,25,2,3,0,0,5,1735231.76946903,7810318.05260339
0,25,4,3,2,0,9,1962096.08419831,1715895.45855526
0,14,5,1,2,2,10,2391898.31683651,4541682.55838972
0,26,0,3,1,4,8,1607481.17542703,6713320.54549305
0,22,0,0,1,0,1,1584497.88164522,4571103.93350208
0,10,1,0,2,2,5,1518433.65251707,4036912.45725924
1,14,6,2,1,4,13,2335209.90681135,6813822.1554001
1,18,1,1,2,0,4,1459231.95738599,5502922.18192534
0,40,1,1,1,2,5,1572519.96975092,2246506.87342934
0,20,3,2,0,7,12,2262356.77677187,5973943.44925502
0,22,0,3,2,1,6,1382581.97869089,6921228.06930047
0,34,6,2,2,0,10,1533039.07191789,5208215.06502593
0,36,5,3,2,0,10,1557839.67765194,5076611.29747098
1,21,2,2,1,1,6,1503502.76949379,6771954.67292589
0,32,0,0,0,0,0,665294.551253748,882366.486071983
0,37,5,2,2,2,11,2191628.83519721,5855103.18935474
0,10,6,2,0,1,9,2072079.64933833,6591044.91231113
1,28,3,2,2,1,8,1860798.14868041,5255562.87382996
1,16,1,3,1,2,7,2040180.18908524,5937837.89450982
1,33,5,0,2,7,14,2860287.20382555,6311788.6715097
1,33,6,3,1,0,10,2044385.8023868,9114939.67273679
0,29,1,0,1,4,6,1372144.92114767,4975130.42214819
0,30,0,0,2,0,2,1451079.88043514,3202179.50711182
1,24,0,0,2,0,2,1276561.55882229,4049980.55902289
0,18,3,0,2,0,5,1461683.0115427,3421682.4633473
1,18,0,2,0,1,3,1513131.86203752,4849619.46429357
0,12,3,3,0,4,10,1965524.4801771,2324393.14886644
0,39,1,3,0,1,5,1271497.46122231,5438383.80811497
0,40,6,3,0,4,13,2043435.44699576,9088808.86659223
0,34,2,0,2,5,9,1956579.58137031,4120459.11676353
0,13,2,1,1,6,10,1688645.29550208,6403120.07696312
0,27,6,0,0,2,8,1481572.36578185,5405714.23432031
0,39,1,1,1,4,7,1828082.67484566,3600834.51308053
0,28,5,2,1,1,9,1345120.84193357,4869215.38560425
0,37,2,0,1,6,9,2256562.87615765,1220481.0765494
0,30,0,3,0,2,5,1775262.99995807,3485069.75815968
0,26,2,2,0,1,5,1387322.73183534,6287765.67934791
0,38,6,1,1,1,9,2065601.45845652,4613865.68259601
0,26,5,2,1,2,10,1841501.3915371,2388707.28700571
1,12,4,3,0,2,9,1995281.20061136,5467434.50592958
1,14,6,2,1,0,9,1781527.6476686,3976559.02792644
0,19,3,3,0,1,7,1746582.83572913,8180034.41276234
0,16,2,1,1,4,8,1927694.81782944,2783141.95320218
1,26,3,0,0,0,3,1073241.68939254,3924150.5607401
0,39,4,1,1,3,9,1985111.35043911,4646424.80676699
0,18,1,1,2,7,11,2162809.86522847,7363688.00698467
0,25,4,2,0,6,12,1942550.23093462,5707362.48548592
1,29,4,0,0,0,4,1566029.42404894,5758981.25205864
1,38,6,3,2,7,18,2430878.54316091,9943762.85995915
1,13,6,0,1,1,8,1713749.80196754,4376313.6540937
1,26,6,2,2,2,12,1989378.16231781,5339058.20866987
0,25,3,2,2,7,14,2617700.87622762,7078033.65718857
0,40,3,0,2,0,5,1350977.58367131,7409881.09107972
0,40,3,3,1,1,8,1648340.33881405,4726153.43727924
0,33,3,1,1,5,10,2058223.50519476,7840295.38904452
0,34,2,1,2,3,8,1781457.83642376,4570715.41865218
1,30,1,1,0,0,2,1229415.04650895,3624412.8934032
1,25,0,3,0,2,5,1195448.70549579,5235582.05207184
0,25,1,3,2,4,10,2367081.42364481,6420370.90302415
1,36,5,1,2,6,14,1846440.23018376,6915607.69298927
1,19,6,1,2,6,15,2463565.22504901,8524990.09404078
0,20,1,3,1,3,8,1538377.787557,5006459.49745396
0,37,6,3,1,1,11,2620238.31266777,4184332.22608366
0,16,5,0,2,3,10,2395397.50352291,4369318.80479556
0,26,5,3,1,4,13,1714148.27482785,5636741.97344543
0,39,1,3,2,2,8,2029267.7415239,9185439.80851919
0,21,4,1,1,5,11,1815209.29211663,7488431.1965806
0,13,4,1,2,6,13,2858035.14866198,9599061.12781234
0,19,5,2,1,5,13,3090664.98875572,10427238.455559
1,23,5,2,1,4,12,2417692.34059403,5470988.46757414
1,13,3,1,2,4,10,1679429.00150182,4883481.53355058
1,20,5,2,2,1,10,1821415.04562555,6315951.84835405
0,32,5,1,0,3,9,2240350.97394984,8237158.4791827
0,14,3,0,2,6,11,1879174.07743282,9169036.09738571
0,29,2,3,1,7,13,1608936.78126154,7414747.10098046
0,21,0,3,2,1,6,1263164.5109396,5277510.89364588
0,21,5,3,0,3,11,2606923.14970579,7499781.68120886
1,15,3,0,2,7,12,2258364.24894048,6265362.79958038
1,33,5,0,1,2,8,2079589.03261791,3849933.31446808
0,31,3,0,2,7,12,2365750.53560381,7370732.14365808
0,25,0,0,2,5,7,1907592.80847162,7096249.99103201
1,20,0,1,0,5,6,1762551.91946038,6068353.29150667
1,16,0,1,1,1,3,1072208.35298562,4496015.88271293
0,10,2,0,0,0,2,1072986.06104781,3736447.83183948
0,14,3,3,1,6,13,2356030.4559276,3950382.80026184
1,11,0,0,0,0,0,1241195.24905283,2929928.04159764
0,39,2,0,2,0,4,1621421.88828698,6384011.95734079
0,10,4,0,2,2,8,2064454.60176657,6226970.68395213
0,28,5,1,2,0,8,2042547.3369994,5353713.69597268
1,30,6,1,2,5,14,2376441.65712914,6734707.42814065
1,20,4,0,0,3,7,1978260.06167522,4928090.0490346
0,32,1,3,0,3,7,2168426.41424832,5340725.85698696
1,24,0,3,2,0,5,1201143.09229854,5927825.86686007
0,20,5,3,1,1,10,2123351.42681337,5366763.2499673
0,16,1,2,0,4,7,1677912.50744824,4767675.36151161
0,31,0,0,1,2,3,1169165.11936073,3802265.4005638
1,32,0,0,2,1,3,1369742.69621759,4632881.71742929
0,19,3,0,1,2,6,1508891.9749562,2956170.17938241
0,37,1,0,0,2,3,1246100.66131129,6282056.79735266
0,17,4,2,2,2,10,1648553.92322518,5540009.18247959
0,34,2,3,0,3,8,2185497.13819485,5970468.47059783
1,33,5,1,1,5,12,2326447.30193099,5557998.94518936
1,31,6,0,2,6,14,2677248.13210346,7623265.62162673
1,23,0,2,1,0,3,1520621.01638925,6742471.24586321
1,30,5,2,0,5,12,2267382.10872602,4429506.75398822
0,29,1,0,2,0,3,1135555.92909482,117810.451239631
0,34,3,0,2,6,11,2195690.57377187,6560637.19552507
0,22,0,2,2,6,10,1641555.49910739,8442022.96844634
0,22,2,0,2,1,5,1768259.91673349,4709010.16993986
1,10,2,3,2,3,10,2179466.85554742,6813287.92357827
0,18,2,2,0,7,11,1753867.73646357,3667418.36332502
0,35,1,1,2,6,10,1856646.12266947,6667616.64074456
1,35,4,1,2,5,12,1878795.54566512,6736463.16394972
1,33,3,1,2,1,7,1490589.43549895,6360541.18344806
0,35,2,0,1,0,3,1679762.37249365,3340787.82269618
1,20,3,0,1,4,8,1519700.78481402,5054114.20455715
0,36,5,1,2,2,10,2169695.15446019,8848916.83941806
1,27,2,3,2,7,14,2707180.12710644,5789176.99394229
1,32,1,1,2,0,4,1586348.58826983,2799919.98324361
1,18,1,1,1,1,4,1414863.03338324,4185912.48435606
0,11,6,2,2,4,14,2290997.07944033,7913276.55861163
1,26,2,3,0,7,12,1874977.13199793,8263729.88389931
0,37,5,0,1,5,11,2467855.35701211,6736074.93327391
1,19,5,1,0,3,9,1715169.57404781,7781712.45540698
0,37,5,2,1,3,11,1758800.26705159,5926993.39846897
0,35,6,0,1,5,12,2075447.9020675,6145902.38803723
0,15,3,2,2,6,13,2574990.79583496,9598168.48088006
0,20,4,2,1,5,12,1717900.34282389,7723706.60395593
0,38,3,2,0,7,12,2320972.17281382,8148000.12504693
1,23,2,3,0,0,5,1733374.82890025,5017597.50923851
0,26,5,3,2,2,12,2422874.12052767,5382961.32286604
1,29,6,3,2,7,18,2289299.67068701,8058526.33596687
0,18,1,3,2,5,11,2509873.4050367,7121474.20998767
0,34,6,0,2,3,11,2393725.48818944,3649709.6996518
1,33,0,3,2,7,12,2560801.22059648,4674297.26277925
0,16,4,3,1,7,15,2446362.56530489,6598881.47544504
0,10,2,3,2,2,9,1837271.28311015,3204705.80211852
0,34,3,3,1,3,10,2147055.3350067,4522294.35086173
1,40,6,1,2,4,13,2297838.73167373,3366683.35751987
1,38,0,2,1,7,10,1870114.97245345,6647883.49292826
0,25,2,3,1,1,7,1917445.08678813,4881952.06064436
0,27,6,2,2,6,16,2911298.40366441,9991947.12327468
1,36,6,3,0,0,9,1706120.18733059,7530880.31072866
1,11,5,2,0,4,11,1814672.442108,3771196.15041272
0,27,2,2,2,3,9,1968332.7236776,5859592.56689881
0,33,2,2,2,3,9,2222778.94923827,4788928.65350233
1,35,3,1,1,5,10,2240938.34948236,4664431.28243972
0,33,2,1,2,5,10,1918804.36381694,6003984.8206011
0,39,4,2,2,2,10,2446850.66019058,5623606.81821832
1,36,2,3,1,2,8,2421050.87082878,3482845.52065277
1,12,5,3,1,6,15,3172562.71816432,3935279.71401787
0,18,1,0,2,0,3,1173594.70240066,5122073.78341484
0,26,2,1,1,7,11,2155274.53499011,5734963.64353338
0,15,1,2,0,3,6,1467580.42815779,4199710.78223027
0,38,1,1,1,2,5,1996913.92201358,3792820.15784078
1,10,3,0,0,7,10,1677904.64540575,7908344.84172742
1,27,4,0,0,3,7,1628499.50069996,3713247.19765668
0,24,6,2,0,0,8,1599064.87971139,7421507.86500733
0,14,1,0,1,5,7,1718938.20618916,6270119.92025873
0,14,5,2,2,2,11,1773824.3337538,8044362.11817549
1,12,0,3,0,5,8,1662859.41157972,7630632.000679
0,15,6,2,0,5,13,2559029.80855529,9842618.10201836
1,14,5,3,1,0,9,1699301.27568651,5903992.6727442
0,19,1,3,0,1,5,1581460.92352208,5023383.72437868
0,17,1,1,0,7,9,2080439.41553098,5537671.58144603
0,13,5,0,2,6,13,2675474.75864405,7581184.61394487
1,37,2,1,0,0,3,1352608.56615683,2532632.29091263
1,10,5,2,1,6,14,2448242.42446461,4186368.06644336
1,38,5,3,0,0,8,1444827.232403,6565142.65551585
0,37,5,3,2,0,10,2317279.06168546,6281508.46940917
0,27,0,1,2,1,4,1754595.34832705,5593345.02632728
1,32,4,0,1,1,6,1500383.57545725,3945363.97819811
0,36,0,0,2,3,5,1757069.36812808,6396039.4097245
1,35,0,2,2,7,11,1947054.3180136,5552584.3043742
0,33,0,2,1,6,9,1542603.67068835,5641071.65705675
0,16,1,2,2,0,5,1285069.65954232,3609515.74794728
0,25,6,1,0,3,10,2267638.3875952,7044986.40400996
0,15,1,1,1,5,8,2017689.52533521,5116678.54515062
0,20,0,3,0,0,3,1197975.61409299,1149811.6350332
1,13,1,3,0,5,9,2219905.49283088,3378312.37989674
1,12,0,1,2,4,7,1365463.64599336,5780900.28242015
0,32,1,1,2,1,5,1616534.21929721,5008834.88902601
0,12,5,3,1,3,12,2194332.87287805,8958183.48618003
1,36,4,2,0,5,11,2087300.04939469,5745567.97583461
1,38,6,2,0,7,15,2608406.0575153,7811051.35577151
1,17,1,1,1,6,9,2035621.8633383,8745402.41708987
1,40,4,3,1,6,14,1942431.37710276,5005447.20002484
1,20,6,2,1,3,12,1546211.99553915,5210602.21175872
0,39,5,2,2,2,11,2447397.98124704,7315304.6509217
0,24,6,2,0,7,15,2531668.3226985,6386179.80264731
0,11,2,3,2,6,13,2173093.00742609,11418976.6766699
1,21,5,0,1,7,13,2966977.43979262,9644243.48827909
0,18,2,2,0,4,8,1393137.84260487,6986332.2305285
1,14,0,1,0,2,3,1305427.36115316,3838751.24724269
1,29,2,1,0,5,8,1938777.57971878,5872567.90014618
1,13,6,0,0,2,8,1859641.91992275,6124855.83233274
1,39,1,3,0,3,7,1859118.69503418,7175767.38526122
1,27,6,0,0,4,10,2127770.01645547,7960077.04642019
0,16,2,0,1,6,9,1531367.85651949,3734685.25318121
0,35,0,2,1,0,3,1367610.47985676,4908261.7504584
1,16,0,1,0,3,4,1800137.40210361,3781597.52124375
0,16,4,2,1,7,14,2436651.27808055,8402261.95776528
0,29,6,1,1,5,13,1611247.87042512,3744711.79256281
0,36,4,3,0,2,9,1977617.49484802,2574369.51423219
0,37,2,1,0,3,6,1100511.18661825,6533554.43464038
0,10,4,0,2,5,11,1803996.07379607,8221574.86790093
1,31,0,0,2,7,9,2123721.86998088,5068471.10357234
0,15,2,1,2,6,11,2194137.85377997,5906176.32780701
1,30,4,0,1,5,10,1853539.43252567,7483281.28022802
1,10,0,0,2,6,8,1350320.74444184,6585046.72590887
0,18,1,2,0,4,7,2071733.1449324,3387719.15777399
0,24,0,1,2,4,7,1821361.17599632,3937614.9388643
1,25,4,2,2,7,15,3462023.1664358,8535109.3543909
1,14,3,0,0,2,5,1551519.467892,3506505.62934463
0,11,5,1,1,2,9,1848179.04818271,5031146.6883832
1,38,4,1,1,1,7,1880926.9642547,3505541.33676037
0,32,5,0,2,7,14,2697046.6090798,6304277.01829359
0,35,2,2,0,1,5,1612724.0852415,6132688.01397405
1,24,3,3,1,6,13,2143712.76424627,5571355.2671361
0,19,2,0,1,2,5,1504689.24643372,4897218.04816458
0,29,2,0,2,7,11,2548942.33039299,9401936.56572437
1,30,4,3,2,7,16,2043056.88953258,7761348.99872603
0,39,6,3,1,4,14,2138255.75558987,6527863.57312609
1,33,6,3,0,2,11,2036515.92346714,7183200.04344391
0,10,2,0,2,2,6,852703.747651533,5352518.62877604
0,13,5,0,0,0,5,1818706.73725981,5426114.367111
0,16,0,1,2,3,6,2045254.76200311,4146024.9158796
0,39,4,0,2,0,6,1558017.35121155,1041651.20936917
0,14,5,1,0,6,12,1797427.16218958,6922764.54049452
0,18,6,1,2,2,11,2253955.68685603,9048467.61696621
0,12,3,0,0,7,10,2002963.50600437,7133638.09775879
0,13,4,1,0,4,9,1862963.43232866,3572270.62871228
1,13,1,1,1,1,4,1250450.85919658,4319847.55046924
1,12,5,0,2,4,11,1435376.59689413,7672480.11879111
1,33,1,1,2,4,8,1364250.26286831,6202472.58719277
0,37,6,0,0,3,9,2204505.26789611,6108998.73173149
0,22,3,2,1,5,11,2242523.98752714,5808286.36368691
1,30,1,0,1,6,8,1997134.12582922,8084417.07310771
1,34,5,3,1,0,9,2135784.50913706,4982562.33346676
0,29,4,1,1,0,6,2088249.39904537,5164662.77768534
0,40,5,1,1,0,7,1393387.02834164,5504221.81122025
1,24,6,1,1,2,10,2064057.79782377,6676819.88637224
1,31,3,0,1,2,6,1782457.35701021,3379940.95425884
0,20,2,2,1,5,10,1941910.72689625,5515283.9746163
1,14,0,2,0,2,4,1163799.02166866,3755993.43181275
0,27,4,0,2,2,8,1954512.56503804,2562783.55815076
0,11,3,1,2,1,7,1913217.97467728,5206949.59773132
0,31,4,2,1,0,7,1645341.31652654,6545804.5402474
0,20,2,0,0,6,8,1831359.691776,3581096.78090951
1,23,1,0,1,7,9,1881666.16519734,2073854.38518666
0,24,5,2,1,3,11,1656632.37478146,8384244.3881537
1,20,5,0,1,3,9,1386502.27073105,6734898.15875665
0,32,1,3,1,2,7,1783546.21550139,3744192.18116697
1,29,2,2,2,3,9,1793358.18210542,4850262.47763672
0,36,3,1,0,7,11,2184321.20098048,4903042.88316657
0,10,0,1,0,5,6,1217392.70579122,5422988.77104813
0,20,5,0,1,2,8,1570195.60474032,3772139.90713661
0,26,6,3,2,0,11,2416841.44181621,9537537.42497001
0,17,1,1,2,6,10,2097744.19949908,4986322.70184898
0,20,2,2,0,4,8,1687924.71313874,4247929.1830235
1,13,4,2,0,0,6,1638948.29945626,3037458.24245035
0,29,3,0,0,4,7,1848789.06887064,4717325.10750687
1,17,2,3,2,5,12,2113640.10852548,5857721.89422828
0,26,1,0,1,4,6,1310397.44521275,3182840.36516982
0,21,0,3,0,4,7,1946419.24909415,4814203.68829522
1,16,5,1,0,6,12,1900740.95172821,6050109.61052945
1,17,4,1,2,2,9,1993344.03053462,5629538.49046014
1,27,1,3,1,0,5,1197144.87469945,4116621.420931
0,20,6,2,0,4,12,1325123.38762818,6295081.71899487
1,20,2,1,0,2,5,1767902.94219459,5437180.72787104
0,13,2,2,1,5,10,1498387.93236451,6780562.85089486
0,22,4,2,2,5,13,2921670.70378777,6793393.32325966
0,22,1,0,2,3,6,1586283.43410021,4125732.26650863
0,21,5,2,2,1,10,1982954.84649705,4509233.38682527
0,16,3,2,2,6,13,1909606.10252005,6046119.5092861
0,33,6,1,2,6,15,3498966.01659722,7912148.07011804
0,15,5,0,2,0,7,1510475.67191988,6359363.01654694
0,12,4,3,2,5,14,2612313.92964567,9892667.13754411
0,11,5,3,2,4,14,1596457.30978548,5340634.84695441
0,21,5,0,2,7,14,1679665.90124029,5079623.75054398
0,24,0,0,1,4,5,1254707.01558494,4490158.50215505
0,37,1,1,0,7,9,2034031.81180595,4377277.06281254
0,36,1,1,2,2,6,1829003.03330736,4721450.06372922
0,11,6,2,1,0,9,2400374.61855299,8074874.61169702
1,34,0,3,1,5,9,2026375.49808532,6092879.44541684
0,37,0,2,1,0,3,1050648.08629786,5877796.59913768
0,40,4,0,0,7,11,1822869.14631924,6589619.45157527
0,38,4,0,1,7,12,1520033.57248072,4300839.55970501
0,27,6,1,2,4,13,1777363.31028937,5069756.6158766
0,38,5,1,1,0,7,2059423.21857218,4134384.79519244
1,11,1,3,1,0,5,1687126.17637425,3807922.37015357
0,35,2,2,2,7,13,2354716.28572954,6817879.63958683
0,34,4,2,1,3,10,1689663.3531409,4294223.89868554
0,15,1,1,1,4,7,2138937.38142786,5574362.4314351
0,35,4,1,1,3,9,2072966.22560013,5793576.45101073
0,37,2,2,0,0,4,1424680.83847443,3895029.21394362
0,27,0,3,1,0,4,1521875.18346888,3982854.55484418
1,31,0,1,1,3,5,1611471.51558906,4783064.7397503
1,13,3,3,2,3,11,2517915.44564677,5833057.7157196
0,37,2,0,0,0,2,1358382.70080951,4401943.43882044
0,16,1,1,1,4,7,2081230.72656814,6918724.35287096
0,32,2,1,2,1,6,1484532.09638593,5027411.3024318
0,14,2,2,2,2,8,1625141.12131703,7401519.40199327
0,36,2,1,1,0,4,1172542.9888654,6442045.60250598
0,31,6,2,0,2,10,2312531.5591586,9280675.80810433
0,32,4,0,2,7,13,2759042.62889193,6910047.8703645
1,12,1,3,2,3,9,2288497.27458685,5480195.42544116
0,27,6,0,2,3,11,1954496.30197981,3812769.5324836
0,21,4,3,2,4,13,2241447.84239125,7004927.77717115
0,37,6,0,0,6,12,1797464.20856218,10866166.1721495
1,26,2,2,0,2,6,1491588.68314771,6464300.15781142
1,17,4,3,2,3,12,2294565.78415637,7848970.83556371
0,24,2,3,0,2,7,1780250.8410228,5375085.33391875
1,10,5,0,1,3,9,1955763.18601916,3641964.54417401
0,27,5,1,2,2,10,1946437.99595574,6933222.94583789
0,40,0,2,0,1,3,1287645.61174082,3998523.28455355
0,35,1,0,0,4,5,1483626.44870285,2486323.43653578
0,18,4,2,1,0,7,1676844.61467123,4271877.96863251
0,20,6,0,1,1,8,2045627.25392553,3191240.40108981
0,21,6,0,0,1,7,1481948.88636289,4365664.97019312
0,28,3,2,0,6,11,2084050.22470619,9484503.40935808
0,31,0,1,1,1,3,1224851.47863985,3599040.87199916
0,24,6,1,1,0,8,1628044.15768389,4320436.30229214
0,11,4,2,1,4,11,2420836.190338,8478473.27013227
1,15,5,3,2,7,17,2267825.18583772,8597140.35698288
0,11,0,1,1,6,8,1920015.35183242,4539505.89316701
0,22,2,3,0,5,10,1390063.55407471,3377963.52522228
0,30,6,2,2,6,16,2616875.96734618,8008491.48040026
1,28,4,0,0,0,4,1225364.17057721,2653803.48648445
0,10,5,1,2,1,9,1704644.77282628,7406972.16663846
1,13,2,3,0,1,6,1907431.76248367,6069917.96791606
0,14,0,1,1,0,2,1168706.42358712,2225802.8653702
0,36,5,1,1,7,14,2664566.43641331,8658416.72972247
0,34,1,0,1,7,9,2151623.23508893,4219308.28699953
0,10,0,0,2,6,8,2048843.53236677,5100727.69478461
1,32,6,0,1,0,7,1275330.89442242,4436103.67077218
0,24,0,1,0,2,3,1127137.10475391,2330308.94821674
0,34,2,3,1,2,8,1705548.68753002,5230443.07017838
0,21,6,2,0,7,15,2478829.70763355,5469566.73340784
0,27,3,1,0,0,4,1606461.56992662,3894408.29997208
1,10,6,2,2,6,16,2371969.18834565,7062574.54579527
1,32,4,2,0,1,7,1866438.44099003,7851757.38104685
0,18,5,2,1,5,13,2432188.91082107,7041458.34832748
0,26,0,3,2,3,8,1603935.508257,3623840.45495479
0,28,4,2,2,1,9,1950585.13409168,5509039.28127558
0,27,0,2,0,4,6,1415510.75366793,7490659.17460221
0,22,1,0,2,6,9,2215373.70280657,4080430.58738424
0,15,2,1,2,3,8,1908621.78196771,7871774.96845963
0,40,5,1,2,5,13,2122907.88695111,7595132.73395597
0,21,5,0,0,6,11,2227268.31828309,5538301.52901224
0,33,2,0,2,2,6,1415317.56501607,3219254.34692247
0,19,1,1,1,1,4,1638358.08315532,4708733.1207945
0,16,3,2,2,6,13,2382849.63020529,6411713.42886906
0,18,2,1,0,7,10,1670426.66755729,5162321.23912901
0,12,2,2,1,6,11,2299683.286878,6935781.20763557
0,12,5,2,1,1,9,1603322.66821248,6767376.773977
1,27,2,2,2,6,12,2010528.2034173,7654492.8809524
1,23,6,2,2,1,11,2286067.43533185,10094055.3948455
0,17,0,0,2,3,5,1323556.49041313,4100487.2305862
0,18,2,2,2,0,6,1920290.69109708,5934127.39210392
1,36,4,3,1,4,12,2366149.8875338,8322573.22034912
0,36,2,1,2,2,7,1920139.67003505,4865849.88719806
0,28,5,3,0,2,10,2022255.74451839,7512931.0709799
0,28,4,2,1,4,11,2236993.35743559,4581770.33237732
0,34,5,0,0,3,8,1867227.18228664,4129864.3041791
1,17,0,0,0,3,3,1358906.68005489,1397012.91592273
0,13,2,3,2,1,8,1757699.63285024,6839117.19928006
1,32,3,0,2,3,8,2433722.0713232,4429795.357322
0,20,1,1,0,7,9,2297537.04710329,7464200.34343228
1,28,0,1,0,4,5,1614242.37705905,4998392.03612414
1,16,2,1,2,1,6,1660010.29666686,1590724.5794567
0,38,3,3,0,0,6,1700316.73571454,6577972.45351463
0,30,1,0,1,7,9,1861776.73273257,5150005.01591546
0,40,5,1,1,6,13,2259078.60671604,10027174.427337
0,10,0,0,1,5,6,2037936.1828913,4702395.1011802
1,28,0,0,2,3,5,1470031.32834776,1318577.08517603
0,27,5,2,2,3,12,2680047.88526612,5516501.60054045
0,35,0,1,1,3,5,1645062.05620404,3900486.78298472
0,18,0,3,1,3,7,1829321.70441651,2394538.94391175
0,15,2,0,0,0,2,954659.683268207,5473281.42336687
0,40,5,2,1,1,9,1725838.29969492,3255239.25040956
0,26,1,2,2,7,12,1893272.5451665,8302114.0057725
0,37,3,2,1,5,11,2367489.73211588,4252579.88027385
0,35,0,2,2,4,8,2161429.79036465,3218257.84005254
1,39,1,3,2,6,12,2481382.23685309,7316692.27829271
0,35,0,3,2,1,6,1574376.75262538,5404749.19576506
1,34,5,3,0,3,11,2187537.8266698,5479958.98188012
0,25,0,0,0,6,6,1806358.87623647,4436828.93345801
0,31,5,0,0,4,9,1552385.94466549,8692427.96564307
0,29,3,1,2,3,9,1960612.71649361,7767615.00721853
1,12,6,1,2,1,10,2195646.76660554,3548730.70401604
1,39,5,3,2,7,17,3726694.93644643,6715696.04331205
0,34,6,2,0,2,10,2363170.92683102,6867801.23903779
0,39,6,1,0,5,12,2047249.52017594,7792612.92045724
1,10,2,3,1,2,8,2354829.04051506,2489356.93744245
0,24,4,0,1,4,9,2269730.4700613,6453561.64816939
1,24,6,1,1,3,11,1644074.73344294,8752168.055016
1,36,4,2,2,3,11,2245662.52871018,7926490.5529027
0,12,1,1,1,0,3,1237741.81126155,3380888.75458755
1,10,6,3,2,5,16,2434925.37531542,10388151.2659771
0,31,6,1,1,5,13,2473827.92047548,7628506.85950009
1,18,5,3,0,4,12,2063047.98577832,4420796.80836072
1,33,0,0,2,3,5,1314334.58118599,5220935.13070072
0,14,4,2,0,4,10,2234841.9629662,7512757.05381921
0,37,3,3,1,5,12,2144072.684677,4142205.671958
0,13,6,3,0,6,15,3045444.11024737,5114492.90122485
0,24,2,0,0,7,9,1459992.36463803,7985639.81900954
0,22,1,1,0,2,4,1209122.63432155,5179393.65709249
0,12,5,2,1,1,9,2146481.67558875,5474076.48088655
1,23,5,1,1,2,9,2289703.17459384,6804728.59831391
0,28,6,1,2,1,10,2481021.68868998,7883903.34021298
0,37,4,1,0,7,12,1539305.20343753,8047660.67109661
0,33,1,1,0,6,8,1824276.89015271,7104044.78888813
0,35,3,3,1,0,7,1911275.47232279,6199116.38764834
1,39,0,1,1,7,9,2147479.67387856,4414862.87476532
0,32,2,2,0,5,9,1526965.48650024,4445033.27840906
0,10,4,2,2,7,15,3159141.44908179,8920449.0040714
0,38,0,1,2,4,7,1913551.12135329,3468428.8714333
0,20,6,0,0,3,9,2031651.86678228,7359779.73738099
0,26,0,2,1,7,10,2215223.78770347,4135218.57949241
1,32,6,2,2,4,14,2808362.49848155,8193096.21363082
0,23,6,3,0,6,15,2869321.55863978,6414531.94439416
0,37,3,1,1,5,10,1895797.65520688,6727121.52793999
1,10,4,3,0,7,14,2712094.39231358,7825540.61514104
0,39,0,1,0,5,6,1399761.9478614,4609183.66676876
0,36,2,3,1,6,12,1882232.37290476,5128374.84117342
0,35,2,0,2,2,6,1599467.39964072,4538491.97004903
1,25,2,3,0,1,6,1649192.9744874,4399536.67080174
0,29,0,0,1,6,7,2060199.55509799,4190458.08752896
0,27,3,1,1,2,7,1413935.58557518,5202843.19631638
0,33,5,2,1,7,15,2628315.29328599,8333887.26383365
0,20,3,0,1,7,11,2055077.88483579,6064614.45877697
1,12,4,0,2,3,9,1686468.87034615,5197001.77461073
0,29,3,2,2,1,8,1771057.46097863,7061436.78282072
0,38,0,2,2,1,5,1670150.38026411,5504342.39782851
0,29,6,3,2,0,11,1660308.90576016,7009251.70623475
1,23,2,2,2,0,6,1744005.92499835,6822816.7606231
0,30,2,0,0,6,8,1678067.28027564,3984082.91485001
0,24,1,3,1,2,7,1585259.76048073,4207050.77108225
1,24,1,2,1,6,10,2293198.99273119,6739644.90449721
0,10,0,2,1,2,5,1437538.04920041,2214899.85042031
0,31,1,2,2,2,7,1918277.32971648,6128835.90128027
1,34,6,2,2,7,17,2434136.43048726,6770913.40172652
0,12,1,3,1,4,9,1320001.64517608,6792443.86107642
0,15,3,0,2,7,12,2223196.60043704,6006175.91003267
0,33,4,2,2,5,13,1710272.75080251,5440756.2961465
0,33,5,3,0,4,12,2204709.92868633,10293921.9906306
1,40,1,2,0,3,6,1425185.11954365,5137311.18990242
0,19,5,1,0,2,8,1638722.72373317,6018600.73927477
0,34,3,2,0,2,7,1711139.10198342,5285720.99709506
0,25,4,3,1,6,14,2072114.73392594,8240102.64430877
0,38,6,1,2,6,15,2114071.35181852,7936644.94637962
0,11,1,0,2,7,10,2084020.79301493,7928516.18170534
0,29,4,3,0,1,8,1281468.14620539,6010579.79168584
1,17,2,2,1,0,5,1558732.95431523,4093357.76091794
1,34,1,0,1,1,3,1283427.06034188,7077541.83966134
0,22,0,1,1,0,2,875722.938734651,799172.029721135
1,18,2,0,2,0,4,1261696.9006196,4995407.06173885
0,17,5,1,2,5,13,2746208.30884021,6532789.29157515
1,34,1,3,1,2,7,1417106.19629177,3671544.25417718
0,17,2,0,1,6,9,2140567.45279278,6504294.96799535
0,11,0,2,0,2,4,1254065.00836393,4482213.18520104
0,16,6,3,0,3,12,2405932.53427066,4922005.21665765
1,15,6,2,0,7,15,2242894.67786394,7259223.71234231
0,37,6,0,0,5,11,1840040.62602724,1722780.62375233
0,10,6,1,0,3,10,1635588.96330993,5397984.29826348
0,15,3,0,1,5,9,1637983.08271206,6490752.63381755
1,37,1,2,1,0,4,1596710.78443086,1921213.81395212
0,22,6,3,0,6,15,3016914.30653529,8203260.77652253
0,14,5,1,1,4,11,1431214.99150619,9068757.7454931
1,30,3,3,1,1,8,1792820.9637405,6194472.36623087
1,17,5,2,1,5,13,3012571.84130472,6093007.57935265
0,35,0,0,0,0,0,1134951.78265891,3934277.16352664
0,15,5,0,0,4,9,1350000.16654717,5054011.18478656
0,14,3,3,1,7,14,3284436.54481729,7814834.97349704
0,39,3,0,0,1,4,1290209.58550041,3535909.31546316
0,26,4,3,1,3,11,1676502.64148494,6886684.7767623
0,22,2,0,2,3,7,1865945.45530713,4087944.09876004
1,22,2,0,1,1,4,1519856.71205734,5652101.8102021
1,16,1,1,1,4,7,2092279.09194243,4754354.22907133
0,13,2,0,1,7,10,1940796.05463422,8152189.37515923
0,20,0,3,1,4,8,1968196.48689583,4527463.93950148
1,18,1,0,2,0,3,1236598.08102991,4407128.40586383
0,29,2,2,0,5,9,1603520.57135932,7615479.4300685
0,36,2,1,1,0,4,1525179.33598061,2232549.28882548
0,26,6,1,2,5,14,2059903.81554332,6962345.30869223
0,18,4,0,1,0,5,1701873.48436917,3847850.93694599
0,13,3,1,0,7,11,2258891.86258208,5660497.3567063
1,34,4,3,1,6,14,1830566.29914296,5264614.49083141
1,33,5,0,2,0,7,1927843.70512574,3589043.69237097
0,26,0,0,1,3,4,1488502.22417368,2397386.88940517
0,30,0,2,0,6,8,1684532.66935343,4714138.42317451
0,22,6,3,2,2,13,1776598.52050005,8446587.47410794
0,34,4,3,2,4,13,1662941.32467554,7621479.31881343
0,35,5,2,1,0,8,1666902.86454954,4452600.90987735
0,19,4,0,2,3,9,1810053.23890133,8298614.26665829
0,22,1,1,0,6,8,2165851.46667188,5581344.76727482
1,24,0,2,2,4,8,1435380.90556276,5980294.8354963
0,12,4,1,0,2,7,1437038.48611059,5683492.09839788
0,10,5,3,2,3,13,2785294.14454638,7130960.74068655
0,27,3,2,0,1,6,1616843.65429719,6154080.26206548
1,19,0,1,0,2,3,874960.888076573,4506210.26154844
0,20,2,3,0,5,10,1656749.6706674,6295537.87356995
1,30,6,0,2,5,13,2583323.13142279,8849644.45526037
0,12,4,3,0,2,9,2059003.78984487,4140821.57418265
1,25,2,0,1,0,3,1231407.0558886,5049968.9485272
0,26,2,2,0,7,11,2170757.95484702,7237539.1047268
0,12,1,0,0,2,3,1459405.13753244,3781305.74478301
1,15,0,1,1,1,3,1434511.85035713,5335903.73330027
1,29,6,2,0,5,13,2042768.34764096,11626535.3336109
0,14,2,0,1,4,7,1701330.00341978,5583531.91454816
0,21,3,2,0,2,7,1773500.45112331,6423466.78366264
1,23,5,0,2,4,11,2265844.62228267,4880974.7566378
1,32,2,1,1,4,8,2195375.97059902,5810807.6083227
0,24,4,0,2,3,9,2068204.21400725,5653303.56520359
0,37,2,2,0,7,11,1937516.47553182,6543808.97999107
0,11,5,3,2,1,11,2355120.25952493,6273987.97554412
0,35,5,0,0,5,10,2108775.5922745,5993550.97607123
0,26,0,2,0,3,5,1527105.53588856,2730704.96003573
0,32,0,0,1,5,6,1660910.25196164,7885446.65612961
1,26,5,0,1,0,6,2048826.70993345,4243649.12730512
0,39,2,1,1,5,9,1998997.10724145,3898106.74204909
1,24,3,2,1,4,10,1958204.65205686,4731549.57979042
0,21,0,2,2,2,6,1441819.03676738,5281814.91747675
0,20,1,1,1,4,7,1563766.33487085,5539796.81578951
0,36,1,3,1,3,8,1482961.62506082,2533175.3221103
0,15,1,1,0,2,4,598972.795524701,3153573.24617056
0,39,4,1,1,1,7,1358904.25560189,4904604.74945781
0,39,5,2,0,7,14,2182661.61565811,9933563.1776956
0,13,3,0,1,0,4,1614262.87778006,5393398.87331619
1,28,3,2,2,3,10,1816173.27405464,11245405.981425
0,28,1,0,1,4,6,1493875.01339743,5850298.56862177
0,12,6,2,0,4,12,2110000.5468225,2762800.18660536
0,20,5,1,2,2,10,2090401.00744677,5084308.45691394
1,26,3,0,0,0,3,1188770.65968515,5429107.43505898
0,36,6,3,0,4,13,2169964.16217333,7594222.71800937
0,36,3,2,0,2,7,1406904.62357911,5366621.16472063
1,36,4,2,1,5,12,2088907.8919337,4632300.19537172
0,13,6,3,0,4,13,2991683.37253176,9311060.62078815
0,13,6,0,1,7,14,2830767.94560908,3843562.75628508
0,36,5,0,2,4,11,1750643.53726589,5702613.59840653
0,13,1,2,2,7,12,2238272.08301319,7445741.49522394
0,16,0,3,1,7,11,2593951.27477654,7336084.93009383
0,26,2,0,2,6,10,1969626.1617573,9561929.71270266
0,16,5,0,0,7,12,2261662.39425399,4464371.31238847
0,39,4,0,2,3,9,2050576.5525171,5382244.6993963
0,17,4,3,1,1,9,1822409.6578924,6050984.35721161
1,33,0,3,2,2,7,2144205.1945309,3871637.1398632
0,11,1,3,0,6,10,1869624.63057877,5862116.30676389
0,15,0,1,2,6,9,1724709.6514182,5135179.12477121
0,40,0,0,2,6,8,1926508.71106105,6075511.2412223
1,36,4,2,0,5,11,2026420.9201063,5267830.31909413
0,36,6,2,2,7,17,2492906.98178903,10619147.618108
0,30,1,2,1,6,10,1611222.78824072,6412834.51691067
0,32,3,1,0,0,4,844658.436749479,3764484.29266437
1,10,2,1,1,4,8,1781688.5483697,6348635.3623419
0,21,2,3,1,0,6,1898310.11648495,5044014.4369419
1,13,5,0,0,6,11,1931841.8664968,6120619.59790962
1,32,1,2,0,5,8,2077791.87693215,6612213.37283791
0,11,2,1,1,6,10,1938501.19785064,6059643.65324973
0,30,3,1,2,7,13,2252091.44178097,6104956.76261071
0,19,0,1,1,1,3,1089063.60386698,3139916.69758794
0,37,2,2,1,4,9,1597423.58385255,4608533.93926739
0,18,5,3,2,4,14,2362879.48174468,6980039.33664537
1,29,1,2,1,6,10,2415989.0329724,8724951.20610879
0,27,6,1,1,7,15,2504177.03750755,7440480.62622779
1,34,6,3,0,0,9,1645182.07979718,5086901.89379526
0,35,5,0,0,1,6,1398779.1316085,6149706.139685
0,26,2,2,0,3,7,1485424.36388907,2256897.56197588
0,12,4,2,1,4,11,1803105.37211402,6147087.76004611
1,37,4,1,1,5,11,2429364.49482321,7384657.37305014
0,18,4,3,2,7,16,2486900.81341376,6306337.56847131
1,13,0,0,0,6,6,1405448.04772457,2810509.32725696
0,22,6,1,2,0,9,1880535.48978479,5398622.41443689
0,22,3,1,1,4,9,1564682.72924897,7850560.84902398
1,21,4,3,2,0,9,1974879.90753522,6757786.59848714
0,17,3,1,2,0,6,1404501.45147286,5902801.64251443
0,32,2,3,2,7,14,2447910.27974071,6950316.64926784
0,31,0,1,1,1,3,1362085.05295391,5919274.3614467
0,13,3,0,0,3,6,1731642.32986524,3534116.07945187
0,15,4,3,2,1,10,1548036.99231192,6574130.74785404
0,28,1,1,0,3,5,1055692.85876182,7263008.35848585
0,25,5,1,1,2,9,1558741.58011894,6927496.11707927
0,33,3,0,0,2,5,1505796.30320836,3449386.22548891
0,37,0,1,2,5,8,2049950.0751036,6323179.59240668
0,18,4,1,0,2,7,1954235.43620856,5406442.59752316
1,11,6,0,1,6,13,2323945.49770912,5982187.25953391
0,33,6,3,0,4,13,2336899.64700847,5473555.74963199
1,22,0,2,1,2,5,1547944.47928891,2886924.23645798
1,27,5,2,1,5,13,1786793.06098048,4214138.1822123
0,38,4,0,1,5,10,1668377.41354607,3372472.74569778
0,39,2,0,0,5,7,2055336.39705028,6278626.57539804
0,32,4,1,2,6,13,2779333.46667905,5490272.63173459
1,21,4,2,1,3,10,2430610.32278874,7541136.79771512
0,13,6,3,1,6,16,2704339.65270795,5332623.17973665
1,22,6,2,1,4,13,2526096.64008463,5332662.11977867
0,21,1,2,0,5,8,2337395.16828634,5658529.97775483
0,23,2,1,1,6,10,2032048.80916522,5700824.63970825
0,32,3,0,0,2,5,1596121.13045289,7984890.62793919
0,30,2,2,1,4,9,2000492.93899817,4700223.15442513
1,11,0,2,0,3,5,1524048.82006742,4003073.70620135
0,40,0,0,0,5,5,1720642.90203881,6054580.91930298
1,18,0,1,1,5,7,1626316.86616928,1970919.45013851
0,17,6,0,0,5,11,2144099.96041404,6320360.28760577
0,10,6,0,1,1,8,1746918.77247824,4866685.87545857
1,19,2,0,1,5,8,1810677.41738778,5629419.30007042
1,22,5,3,1,6,15,2483410.07447151,7792880.81856712
0,17,2,2,2,3,9,2154346.16234794,5901668.73675157
0,34,2,2,2,5,11,2011576.62391478,3168747.07153045
0,19,4,2,0,4,10,2267615.51657547,3315217.44261047
1,30,3,2,0,5,10,2485822.68344554,5052753.01926136
0,36,5,2,1,4,12,2507846.45463027,8048252.0568004
0,22,3,3,2,0,8,1338041.41106858,5403297.66651268
0,15,6,1,2,2,11,2272815.92008926,3068509.63649159
0,18,6,0,2,7,15,3106783.34349349,5686771.39259747
0,32,5,3,1,2,11,1823671.57263283,4490566.26741379
0,21,0,3,2,5,10,2575435.40558467,6703217.75897226
0,38,6,0,2,6,14,3081203.63536952,6049011.47559765
0,13,4,1,1,1,7,1730309.90266047,2572391.87389016
0,15,6,2,0,3,11,2447083.13907277,3673954.77130075
0,21,3,1,2,4,10,1778780.2932551,6778651.90974842
0,21,4,1,0,5,10,2998690.77341285,7173561.46166862
0,38,0,2,0,0,2,985412.473679393,4852183.45499525
0,19,5,3,2,5,15,2700748.05213721,7476596.6005449
1,36,6,3,0,4,13,2425912.65189516,6007805.16833372
0,35,3,0,1,4,8,1999661.30781996,4618959.25936209
0,17,5,0,1,6,12,2387447.51154897,3923898.8998278
0,24,4,2,1,0,7,1605637.92007841,1913895.18599089
0,24,2,1,2,3,8,2339424.99784006,3505144.40246462
0,28,2,1,2,7,12,2428269.56781711,4807392.9484728
1,23,2,1,0,4,7,1496885.77726928,6327148.62993163
0,35,4,2,0,0,6,1696916.87929961,4023097.56191936
1,24,4,2,0,0,6,1622562.08775748,7251866.60161025
0,15,1,3,1,2,7,1420001.30521257,5783781.15327409
0,24,5,3,1,5,14,2942049.38852263,5350672.01083661
1,33,4,0,1,4,9,2244522.71589379,4660619.15439947
1,38,5,2,1,7,15,2535951.67474744,9605300.38871555
0,37,1,0,0,4,5,1353165.22433767,4007064.22871633
0,33,3,2,1,3,9,1765549.42504322,5002720.67002866
1,40,2,0,2,2,6,1391677.00474718,3778828.56759707
0,26,6,2,0,0,8,1916633.02319399,9453186.87885546
0,29,2,2,2,5,11,2407989.08880763,5063417.91981448
0,19,4,2,1,7,14,2238906.88031065,10164012.6553836
0,30,4,1,2,4,11,2314401.95141183,5933902.06899769
0,26,0,3,0,4,7,1687323.15217978,5832011.87565389
0,33,3,2,0,1,6,2071200.58801579,5749193.95796632
0,40,4,0,2,6,12,2562049.58291929,8129997.84425
1,29,4,3,1,5,13,1812177.62781985,8305897.35536757
0,30,2,3,2,3,10,2414173.75342982,3447543.41136941
1,26,4,3,1,5,13,2232170.73636148,9705459.03717415
0,31,6,1,0,6,13,3020561.44622326,7688880.3570759
0,32,5,3,2,2,12,2207986.43706722,5075724.70531847
0,32,5,1,0,7,13,2259559.59456382,6550434.43782029
0,40,6,3,2,7,18,2427074.39968113,6330860.05363313
0,15,3,0,1,6,10,2301685.34209967,8967421.64160201
0,26,4,0,1,4,9,2068216.81113551,7004228.83200093
0,32,2,0,1,7,10,2282386.25694291,3695379.30659143
0,17,2,3,1,1,7,881254.647070097,5416426.65936195
0,38,5,3,1,7,16,2298195.65338564,7502999.36016044
1,10,0,0,1,2,3,1395830.80571472,6677195.66087527
0,23,2,2,1,4,9,1762936.61719232,4993306.72072018
0,17,3,3,1,7,14,2705501.70113884,11313789.308024
0,18,3,1,2,1,7,1345712.639699,6878338.3928452
1,34,1,1,2,0,4,1281440.69195768,2813741.39585831
1,10,0,0,0,3,3,1284708.12424026,1468331.02743813
1,33,1,3,1,6,11,2383699.13954786,5538846.33958036
0,26,6,0,1,3,10,2149952.18134857,6997555.2023752
1,22,5,2,0,4,11,2708113.41877335,8850730.38072331
0,34,3,0,2,5,10,2044300.72996864,9878102.66037108
0,36,1,1,0,2,4,1454911.46349079,1871627.42721551
1,32,4,1,0,5,10,1867967.04610109,5667289.59352984
0,15,0,0,1,2,3,1528945.1736817,2801194.44400968
0,25,4,2,1,5,12,2513798.17499666,5338797.06169683
0,14,4,3,2,0,9,1756456.52214363,7419777.01546755
1,14,2,2,1,3,8,2029099.06936288,2470855.76321803
0,24,0,0,2,1,3,1532642.82954447,4773566.16639804
0,32,1,3,1,6,11,2489153.77813003,2967580.23629467
0,33,2,1,2,5,10,1424242.50581476,7553081.70127054
0,27,4,2,1,1,8,2150494.44221033,5709734.40602907
0,24,5,3,2,2,12,2612788.55376543,5688549.87641785
0,26,0,0,0,6,6,1648717.9524474,5584346.14804797
0,16,4,1,0,0,5,1482349.12670083,5340697.32640873
0,22,0,2,0,2,4,1194968.75727592,3173878.02926869
0,23,3,1,2,3,9,1985455.89012102,7585888.34118519
0,19,2,3,0,4,9,2624963.9875024,6128099.74154133
0,19,4,0,2,1,7,1529766.40032247,6476908.95744949
0,25,1,1,0,7,9,1580966.20182005,9348851.30582562
0,40,6,3,2,7,18,2749584.49995257,13600018.6889146
1,22,2,1,1,5,9,1659012.65945763,6097013.75972279
0,10,4,0,2,4,10,1827967.91537793,6073118.38256776
1,15,0,2,0,6,8,1606415.11586486,8304270.32030947
0,39,4,3,1,2,10,2189758.57775191,5216713.75663915
1,11,6,0,2,4,12,2588463.88798281,9536063.61825488
0,26,3,1,2,6,12,2436915.73682967,6402167.93817329
0,13,0,1,1,7,9,2208768.04708188,5677132.89569614
0,36,4,0,1,4,9,1793027.64000605,6965588.50823389
0,17,3,3,0,6,12,1553878.8155152,6411187.71333563
0,28,0,0,2,1,3,1227289.23741829,2571235.75290359
1,20,0,3,0,0,3,1157463.08415643,1006946.82025031
0,25,3,1,1,5,10,1809934.77687721,7250796.19303841
0,15,5,0,0,3,8,1653550.03985607,6967429.69217405
0,29,3,3,2,0,8,1749381.72800311,7450956.46737668
0,36,4,1,2,0,7,1398695.64552169,5296078.99480803
0,36,4,3,1,6,14,2391370.57657404,7447656.89174103
1,34,3,1,2,3,9,1854195.44459549,4560821.26079112
0,23,6,2,0,6,14,2611894.26218661,4926962.96984246
0,20,6,1,0,5,12,2125264.53042362,6540511.77377158
1,15,2,1,0,6,9,2266215.48801615,5369525.06936154
0,36,0,3,1,5,9,1393360.2321364,4979158.86680312
0,35,2,1,0,1,4,1264842.56701287,3342194.99930821
0,11,5,1,2,7,15,2405689.04841517,6790414.80251116
1,22,5,1,1,5,12,2224011.31844871,7380186.50503667
0,39,3,0,2,0,5,1501395.02097177,4054309.31878168
1,40,6,2,0,1,9,1628627.27666419,5317050.64006225
1,26,5,2,0,1,8,1552880.18480839,5756368.88436578
0,37,1,3,2,7,13,2431120.62216028,8514618.18264718
0,32,4,1,1,2,8,1519739.308902,3967977.45029387
0,16,1,3,1,0,5,1540540.60998012,1984334.40629544
0,31,0,2,1,0,3,974669.455329731,4063821.90139296
0,13,5,1,0,7,13,2242136.4402229,8125257.81952121
0,36,5,0,0,0,5,1381764.23113886,4640853.55749795
1,32,3,3,0,7,13,2234102.6998103,8805546.43629937
0,23,4,1,0,7,12,2266046.48409732,8458933.17646805
1,30,6,3,1,1,11,2478664.35393734,5828070.65628804
0,35,6,1,1,7,15,2883093.13175821,9220892.62929482
1,31,4,0,0,4,8,2007149.4022985,5821556.48032217
0,37,3,0,1,0,4,1311116.81043987,3449230.8663363
0,28,2,3,0,4,9,2337297.47400652,4889778.56458514
0,32,4,1,1,3,9,1623355.37121655,8592560.27819079
0,38,0,2,1,4,7,1415406.45475038,1325255.59983097
1,24,5,2,0,6,13,2417688.50307573,4592455.47434334
0,14,1,3,0,5,9,1217968.08374618,6228261.98970988
1,40,2,3,1,1,7,1746807.48605151,5118584.75278005
0,23,1,0,0,3,4,1695343.87654119,4848877.64145669
0,14,3,1,1,3,8,1988451.94337816,9792354.0537447
0,11,0,2,2,1,5,1771907.31479671,7321264.37135715
0,29,5,3,1,5,14,2978563.83654088,6155445.01995307
0,29,1,0,0,5,6,1674155.25850321,3346235.55323333
0,29,4,1,2,4,11,2328024.00439039,6638436.2405598
0,40,1,2,1,1,5,1399092.65952152,4629711.03057851
0,20,1,1,0,1,3,965853.549220791,4074849.1396166
0,32,2,1,1,5,9,1949088.73930672,8129000.91177665
1,31,4,3,2,1,10,1884247.04629399,4831396.31077386
0,11,6,3,2,7,18,3188401.59837655,10752305.660285
0,31,5,0,0,4,9,2030812.97856098,3893481.71169203
0,33,3,1,2,6,12,2233755.72925166,6011055.79314848
1,15,3,1,2,3,9,1556134.74628928,11191380.1232589
0,22,2,0,0,6,8,1711009.66461299,6901762.48051979
0,25,2,1,2,4,9,1554492.92189273,5428979.88021267
0,28,2,1,2,3,8,1996186.12583564,5064908.61060302
0,30,6,3,1,3,13,1947928.66730488,9722669.83717212
1,25,0,0,0,3,3,1015388.90093081,2860666.64924011
1,28,5,3,0,7,15,2336206.64050246,3175635.25585903
0,20,0,1,2,4,7,1230014.45457014,7120445.66204302
0,12,2,0,2,2,6,1385277.15144625,8079034.135955
0,19,3,1,0,7,11,2246711.00136409,4318821.95048686
1,17,0,0,2,1,3,1306248.81190233,3799574.38733739
0,14,0,3,2,1,6,1818753.78868984,2555055.1509817
0,23,3,1,2,1,7,1674318.76173643,3770951.41078524
0,27,6,3,0,4,13,1988114.35165229,8629896.63322078
0,30,1,3,0,1,5,1841034.86414537,3425740.10562157
1,10,0,1,1,0,2,1476262.58551302,3898379.53806515
1,23,4,0,1,4,9,1856310.31532103,7193978.1233272
0,23,0,2,1,0,3,1143597.49026312,4188646.30493589
0,21,2,1,0,5,8,1472278.20138679,1591564.12539509
0,31,4,1,2,3,10,949824.739367189,6180394.77935043
0,15,6,3,2,6,17,2124460.4245531,6626404.05897761
0,38,5,2,0,1,8,2000942.19562356,4232335.695289
0,21,1,0,2,0,3,1078476.58753621,2410672.2785046
1,11,2,2,2,5,11,1793046.29024196,6318549.96983487
1,34,1,3,1,4,9,2241300.71256943,4433128.40925931
0,38,4,2,2,3,11,2344025.98816297,6232973.47669251
1,22,5,2,0,1,8,1995051.38175365,5601632.51840065
0,27,5,2,0,4,11,2088211.14720283,6801867.68682873
0,32,4,0,2,6,12,1953190.45153731,5317486.43641858
1,16,6,2,2,6,16,2501153.18862743,6277996.00863383
0,38,6,2,2,6,16,3218984.72012886,9878063.29477188
0,20,2,0,1,2,5,1703274.70249276,5724384.13741283
0,34,5,3,2,1,11,2985189.57074258,4480810.10996385
1,10,0,3,1,5,9,1502728.20866329,3790058.90665084
0,33,2,1,0,4,7,1718251.69045101,3092820.93864714
0,33,2,0,0,4,6,1590170.62402853,5576794.5542173
0,23,4,2,2,6,14,2133922.07758298,7966124.30242957
0,40,6,2,2,7,17,2650344.15036734,10001924.7637038
0,16,3,2,2,2,9,2839427.57405415,3018475.66847871
0,15,2,0,0,5,7,1647700.37379119,7061130.75924315
0,22,0,0,0,7,7,1811019.83731527,6644709.60067204
0,34,2,1,0,0,3,1369346.76577077,4160776.03905881
0,15,4,3,0,2,9,2038424.98974059,5005317.38256235
0,32,6,2,0,4,12,1891675.46535665,5166215.91787813
1,36,2,2,0,3,7,1678333.83981947,6615617.8713342
0,34,4,1,0,0,5,1876361.75305853,2413403.60619393
1,36,2,3,2,0,7,1762870.95153332,4591502.01830144
1,11,6,0,2,3,11,1496921.90036487,4032581.71092486
0,38,1,0,2,2,5,2006408.97399048,1284158.57588479
1,22,3,0,0,6,9,1789350.96142262,5324024.43830822
0,35,5,1,0,7,13,2718325.80551267,6437601.67509123
0,39,4,2,1,4,11,2394543.01634228,6153569.62766122
0,31,2,0,1,4,7,1626846.81486706,5649679.37159206
0,34,5,2,1,4,12,2275404.82036516,7020529.92594801
0,25,3,2,0,1,6,1342558.36404207,4826652.51883102
1,30,5,1,2,1,9,1813723.33638933,6245838.72063706
0,19,6,0,2,2,10,2385197.15050661,6971104.1592231
1,11,6,1,0,3,10,1932203.69295299,5853782.59326048
0,37,0,1,1,7,9,1802597.35393535,7149281.41740779
1,40,4,0,0,5,9,1720605.27715376,6703649.96451846
1,25,5,3,2,2,12,2168097.90132056,7731997.53715973
0,27,1,3,0,4,8,1974214.27118313,2133994.94009341
0,26,4,3,1,0,8,1503476.61318555,5876416.1605365
0,24,0,2,0,3,5,1441818.56720639,5331108.19665073
1,16,5,3,2,2,12,2460065.32549661,5115151.42650882
1,19,2,2,2,3,9,2057705.96125377,6185710.49623652
1,23,4,0,1,3,8,2155751.26292753,2271998.95354662
1,17,4,3,1,3,11,1937384.19366043,5021473.37063137
0,31,4,0,2,3,9,1777530.93283025,5239646.29180602
0,24,3,3,2,1,9,1686947.28489992,7328662.01362361
1,16,3,3,2,4,12,1835036.70522507,10353883.0241719
1,24,1,2,0,5,8,2204083.58052658,4457961.08822922
0,29,3,2,2,1,8,1563322.41890718,5372758.24541341
0,16,5,0,0,4,9,2133933.69489199,4957502.51887027
0,14,0,0,2,7,9,1796137.81107453,5695600.33286839
0,17,1,2,1,4,8,1766308.28770012,2117131.26180663
1,37,0,1,2,5,8,1318132.18683355,4891667.02699486
0,15,1,3,1,3,8,1958440.91862299,5156849.24571377
0,30,0,2,2,7,11,2552178.06458175,6540576.14441692
1,10,1,0,0,6,7,1570414.52269032,2888211.35339988
0,36,2,2,1,4,9,1921795.9673346,7854994.55100881
0,28,5,3,2,1,11,2013356.43827571,3450495.92681539
0,10,4,3,2,6,15,2582186.8510078,4941516.50579302
0,28,3,1,2,3,9,1723310.48022203,5767400.40902071
0,18,2,0,0,4,6,1458834.70026094,5594811.14798415
1,16,6,3,0,7,16,2983293.85927968,6319276.99892039
0,23,6,3,2,0,11,2079085.75055387,9607911.61915308
0,27,1,0,2,3,6,1276342.29214665,5140169.96231069
0,34,5,0,1,2,8,1658722.62671393,5541146.48555068
0,18,4,0,0,3,7,1884937.3707675,8213603.9925132
1,38,3,0,2,3,8,1714809.58909014,4183465.4969729
0,28,1,3,2,3,9,2003662.00122845,4658277.42979072
0,22,6,3,0,0,9,1786339.67057489,6922143.62596806
0,29,0,0,0,4,4,1619640.8331325,4567741.05943414
0,10,1,1,1,0,3,1366829.58195311,2875366.21219447
1,23,6,1,1,0,8,1388515.02890759,4506929.01417902
1,31,2,0,0,1,3,1344363.45803009,2841817.67397767
0,22,3,3,0,3,9,1639860.76537895,4820899.30840876
1,27,6,0,2,2,10,1691483.60622489,2341195.47893679
0,17,2,1,1,6,10,1466652.01620772,6852915.86366183
0,39,4,1,2,2,9,1241260.51649661,3007986.1051411
0,35,1,1,0,0,2,1188651.96336531,2825577.59192824
1,24,2,3,0,6,11,1776192.25421825,6598746.57089588
0,31,6,2,2,3,13,1629620.4658724,4908275.682582
0,12,3,0,1,2,6,1618699.23890674,3429226.51872794
0,23,5,2,1,1,9,1823857.14334382,4286644.36937783
0,23,4,1,1,3,9,1389233.33657507,7058466.14001872
1,27,1,0,1,6,8,1560704.33273567,5358177.17445042
0,16,6,2,1,2,11,2148628.68388459,6214072.44910066
1,10,6,1,2,3,12,2422858.3108629,6328436.95688753
0,11,3,3,0,3,9,1701441.90584532,5842732.57478284
1,30,3,0,0,5,8,1582980.41981181,5279707.55625684
1,10,3,1,0,0,4,1244327.79810121,7749243.10061008
0,39,4,2,2,7,15,3822087.65945709,7488301.41202683
0,29,1,0,1,6,8,1821155.12164622,8728865.36384733
0,40,1,0,0,5,6,1569161.59120301,4428963.58044048
0,19,3,3,2,6,14,2289211.24391347,6761555.27451278
0,25,6,2,2,0,10,1767369.47109549,5434708.33110047
0,36,0,2,0,4,6,1667408.62159992,4468832.04641754
1,17,5,3,1,2,11,2245803.70472173,4744064.31708434
0,28,0,1,1,2,4,1534254.3266891,2246112.76464826
0,38,3,2,2,1,8,1994999.09790916,6077460.91981027
0,32,5,1,2,3,11,2263499.11753317,5134611.80053072
1,12,5,3,2,4,14,2834163.4246839,6583305.55829664
0,18,4,1,0,2,7,1293132.16309401,5885907.3912472
0,38,0,1,2,1,4,1536595.4580894,1692659.79317325
0,26,1,2,2,4,9,1678426.28200699,3362723.67775185
0,32,2,0,1,3,6,1469001.46414989,4769181.71802733
0,25,6,0,2,7,15,2427856.41042162,8813990.82279628
0,17,2,0,0,2,4,1315806.14361655,7771146.97366895
0,12,3,1,2,3,9,1684514.3135793,6754543.56430208
1,21,6,3,2,2,13,2442714.04478704,8503290.65880893
0,16,1,2,1,7,11,1909783.41134132,7393346.00995242
0,36,5,1,1,0,7,1813303.18684487,4842102.859954
0,12,2,2,0,0,4,1223276.0242439,6253665.69350113
0,36,1,2,1,0,4,1607277.24520966,4881492.05021964
1,35,4,0,2,5,11,1999291.99610396,7008767.44308474
0,26,3,3,1,6,13,1515134.69156099,4417359.03280101
0,24,0,2,0,0,2,1009134.26557856,3743408.81591303
0,23,6,2,1,0,9,2583127.30964283,6461399.73262355
0,29,2,2,2,1,7,1401043.43269453,6432672.36908105
1,34,3,1,2,6,12,2415526.3379835,5262666.98127104
0,20,1,3,0,3,7,1693859.96419854,4765236.63664144
1,31,6,3,0,2,11,2085203.30068438,6427403.71833201
0,10,6,3,2,5,16,3018270.66209137,8104511.68670209
0,14,0,3,1,0,4,1223807.87180633,4498556.9356672
0,24,3,2,2,3,10,2221983.78920647,7577041.56816437
0,11,6,1,0,4,11,2272523.751028,3517049.979911
1,14,4,2,1,7,14,1976941.11398523,8268728.93054533
0,13,1,0,0,2,3,1256154.81644827,2395563.91140187
0,36,3,1,2,7,13,2241324.75207158,5731650.59572449
0,15,1,2,0,1,4,1743788.35617831,4732956.36840147
0,11,3,3,1,4,11,2190399.24269459,7308579.8191964
1,38,1,3,0,7,11,1672140.57407621,5539322.8757785
0,15,5,3,0,7,15,2310090.0846516,9468262.74791045
0,34,5,1,0,2,8,1782727.14323231,8900787.21209791
0,35,2,2,2,4,10,1518198.18197593,4648390.17107687
0,10,0,3,2,1,6,1428947.58923533,3005894.74027753
0,23,3,1,1,2,7,2062055.38642647,4710755.59560224
0,33,3,1,2,6,12,2138140.11459997,8276611.9829729
0,39,3,1,2,1,7,2100495.70690689,6159761.08203329
1,40,6,1,0,2,9,1512457.54039636,5963209.23129186
0,37,4,1,0,1,6,1804182.57533195,2970828.5225726
1,21,4,3,0,1,8,1527951.69848532,3246807.4134066
1,24,3,0,0,3,6,1440336.59893182,1195060.88432434
1,14,2,2,0,0,4,1122078.48065562,4106668.48925719
1,38,2,0,1,5,8,1969228.60897628,4387499.32817579
0,14,2,3,1,7,13,2726416.67457534,6172190.04675107
0,16,2,2,2,1,7,1463083.77547897,6899430.69273884
0,34,1,1,2,1,5,1144361.63815511,8607102.21631883
0,37,3,3,1,5,12,1789392.32688603,5407496.45144706
1,40,6,0,0,0,6,2020283.93856371,1824663.41258724
0,22,1,0,0,5,6,1468659.12857818,7459032.44254265
1,24,0,0,1,4,5,1559948.6694955,3180335.23898109
0,36,0,1,2,0,3,1053663.97320208,2425611.64829677
1,27,6,2,2,1,11,1444872.25893645,7699758.12590254
0,30,2,3,1,5,11,1793868.40423895,7712074.62074732
0,14,1,3,1,0,5,1326170.77547568,1814937.78531582
0,30,2,0,2,0,4,1745094.24304753,4078306.66779586
0,19,6,2,0,3,11,2264709.90556885,7705336.91655661
1,20,1,1,1,6,9,1799468.51892798,5437944.72847567
1,35,5,2,2,2,11,2401352.9774726,3096412.87887372
1,21,6,0,1,2,9,1941491.07146692,8105622.85979324
0,18,6,1,2,7,16,3367234.20561596,10142804.5856414
0,11,4,1,2,3,10,2581386.57346933,6835603.74440037
0,18,6,1,0,5,12,2559771.61078912,6351476.07900697
0,25,5,0,0,3,8,1681864.32985657,6156134.2643133
1,39,1,3,2,2,8,1978651.19665949,3967393.18145361
0,24,5,3,1,6,15,2924882.91635034,4283068.49446587
1,26,6,1,2,5,14,3316040.27509265,3046655.07112171
0,10,1,1,0,2,4,976168.436255012,5152911.47451759
0,28,3,2,0,5,10,2099709.29130083,5886099.2155126
0,14,2,3,0,0,5,1573973.74771878,5539327.75476595
0,13,0,3,1,2,6,1389312.05198093,7242733.37739578
0,23,4,3,2,0,9,2206931.19445742,7165940.1674647
0,29,0,3,2,2,7,1512520.51888216,5438665.63638605
1,16,5,3,0,2,10,1858701.70362347,4559019.15242683
1,38,4,3,1,4,12,1972799.68931306,7379103.2887027
0,30,2,3,2,4,11,2667466.22379812,6003154.22349243
0,40,1,1,2,3,7,1531882.23309154,3851780.13267161
1,16,4,0,0,2,6,1810357.61355347,5186066.9485702
0,15,6,1,0,0,7,1204871.72029047,4693495.74925809
0,40,0,3,1,7,11,2388406.68924551,5775972.36330351
1,31,6,1,1,1,9,1735583.72638766,4250870.54015132
1,37,2,3,0,1,6,1756018.89055803,5945270.27277482
1,15,1,2,0,6,9,2015565.82445078,3259262.76134757
0,29,3,3,2,5,13,2361271.14704896,7245448.40295214
0,37,3,1,0,0,4,1045006.81309184,4941928.30032776
1,31,5,3,1,5,14,2170365.42519234,6900431.80489337
1,21,1,3,2,5,11,2658561.9194939,6740591.34640148
0,27,2,0,2,0,4,1718193.8252166,1290725.77989726
0,27,5,3,1,6,15,2965658.239723,7723917.02455238
1,40,6,2,0,7,15,2554494.27246656,10298367.0897869
1,12,3,2,0,1,6,1696713.73154751,5252996.46798044
1,32,1,3,1,1,6,1639564.79713328,4009269.12646285
0,38,0,1,1,4,6,1424289.64178113,4724666.80721394
1,15,2,1,0,6,9,1993841.52197163,4336070.82234482
1,32,5,1,2,6,14,1911352.44986149,10893419.0075876
0,38,5,1,1,1,8,2339813.31875431,5432715.41100963
1,40,3,0,1,0,4,1394581.65571958,3048670.69215061
0,34,0,2,1,6,9,1928649.49286476,6726791.65982667
1,24,5,1,1,1,8,1682936.06242079,7729667.97060343
1,24,5,1,2,0,8,2062730.02882025,4157302.53308263
0,26,0,1,0,1,2,1303488.94021996,3653394.71832087
0,21,6,1,0,3,10,1682895.49581061,2803340.44185389
0,17,3,3,0,2,8,1540913.50613864,7081216.74727455
0,20,0,0,1,7,8,1898672.54831612,5968391.46334801
0,22,5,2,0,1,8,1412734.35227546,5418527.44024933
1,38,5,3,1,2,11,1929580.61856399,4743195.75968851
0,35,4,2,1,4,11,2365909.88306558,6642602.04221077
0,40,4,0,2,6,12,2402962.80079076,9399010.53162345
0,15,6,1,1,7,15,2790482.19053982,7184743.98709264
1,40,4,3,1,1,9,1130753.18971122,8234510.97337107
0,21,2,0,1,7,10,1678809.28659364,6344390.52457292
0,10,3,3,1,2,9,1768016.88238876,5613941.08806866
1,32,3,0,2,4,9,1150288.0924258,8839874.64020867
0,14,6,0,0,5,11,1945456.69997093,7608879.09939536
0,39,0,2,0,5,7,1588864.54231421,4424067.34847845
0,18,3,3,1,7,14,2507708.52158063,8678747.54822109
0,25,0,2,2,4,8,2223875.40363531,5179179.4194846
0,34,6,2,1,6,15,1910673.33870127,8554024.43675522
1,19,1,1,2,3,7,1691008.18598953,7732474.21198216
0,30,0,0,1,1,2,1347391.26764964,6425507.27109296
0,22,6,1,2,0,9,2490818.06282624,5134164.91570661
0,18,0,0,2,1,3,1581751.12512451,2712571.71696586
0,28,5,1,2,4,12,2709403.19233588,8140232.39127782
1,19,1,2,1,4,8,2131793.90383459,7228994.39820857
0,15,3,1,0,6,10,1941005.40331268,5949234.25758988
0,25,1,3,0,6,10,1996591.10837974,4590301.72301068
0,19,2,0,2,5,9,2170577.39370717,3878847.32648123
1,28,5,0,0,0,5,1406556.64338523,5972182.44268178
0,31,6,0,0,3,9,2213033.43623234,6298000.14687728
0,39,2,0,1,1,4,1486288.54345347,4229272.84481129
0,17,6,2,1,7,16,2035324.18536519,7114115.71029619
0,36,3,1,1,4,9,1780609.83423438,4448876.76887436
1,30,1,2,1,6,10,2098761.57359483,6744018.26375717
0,10,1,2,2,3,8,1770476.05916737,3470799.02591194
0,10,2,2,0,6,10,2160095.64918647,6005895.20403019
0,25,5,2,2,5,14,2386853.87535219,8213522.34930765
0,33,5,2,0,3,10,2162002.98993293,3859147.56696897
0,10,5,1,0,4,10,2403242.92839567,4973901.92863549
1,10,2,1,0,4,7,1957272.32139861,2371725.56840419
1,26,0,2,1,3,6,1702707.2867558,6041718.48887808
0,24,3,2,2,4,11,2155171.17148707,7745116.70238795
0,19,3,1,0,4,8,1593935.5147998,3461482.17722644
0,22,1,1,1,0,3,1249093.78078179,5958448.4421441
1,33,3,3,1,7,14,2370908.19296849,6427237.5670868
0,30,4,2,1,7,14,1741935.57397963,5340194.70785663
0,12,5,2,0,1,8,1429261.81034924,4465327.73495127
0,17,2,3,2,1,8,1862109.32516491,5083067.55762953
0,27,1,1,2,0,4,1614371.17009418,3795238.57598297
1,24,0,0,2,3,5,1252445.03921541,4048830.56204295
1,28,1,1,1,0,3,1732218.53548484,4171184.37597154
1,19,1,1,1,3,6,1721708.48765525,5049092.63256031
0,21,6,1,2,2,11,2290684.16788505,8000529.82616989
0,35,2,0,0,7,9,2364431.32062754,5597366.41027934
1,36,2,0,2,0,4,1497178.91850379,5760691.37554589
0,24,5,2,2,3,12,2223655.05260425,4223784.92951913
0,14,2,0,0,2,4,1448242.43332381,7686632.51711834
0,23,5,3,1,2,11,2273328.29424056,9919131.49174475
0,37,0,1,0,6,7,1374663.45728304,3829476.11253596
0,16,5,1,1,0,7,1961881.89126014,7395218.14782742
1,21,3,2,1,6,12,2189935.98526632,8486200.26838055
1,24,5,1,0,7,13,2009174.17283383,3566745.27044823
0,24,0,0,1,2,3,1246423.38690152,1476687.50270438
1,34,6,2,0,6,14,2991218.10128057,7429059.2681014
1,14,4,1,1,5,11,3197265.5867966,7348527.61196114
0,12,0,2,2,3,7,2072713.24608377,4414253.38653184
0,29,0,0,2,5,7,1747896.67047075,2809268.84318116
0,38,4,3,1,6,14,2782014.54075778,3992864.45423971
1,18,1,1,0,7,9,1646248.17086613,5069074.16923657
0,40,2,1,1,7,11,1826075.33547198,9520547.71294656
0,21,0,0,0,4,4,1606368.99599257,3146975.79077855
0,18,1,1,2,6,10,2020483.32151867,4137943.41512079
0,26,1,3,0,2,6,1453827.22932104,4431018.87753709
0,14,5,2,1,6,14,2284904.32255988,9583087.48697646
0,22,6,2,1,4,13,2514992.46556653,5833613.44220025
0,40,4,3,2,7,16,3226865.13206493,6936396.82597292
1,34,5,3,1,2,11,2036760.30101457,3785769.91992072
1,13,1,3,1,7,12,2435759.80003185,6101810.96523757
0,38,0,3,1,3,7,1536268.04188495,8236851.42810053
0,25,3,3,2,5,13,1860390.0334885,8195975.32481736
1,28,5,2,0,7,14,2708176.46672132,4761940.77516722
0,29,0,3,2,4,9,1864650.33159635,6850964.02693064
0,31,5,3,0,5,13,2243090.70994923,7247989.89245514
0,17,0,3,1,3,7,1483196.49116972,2760991.49552706
0,33,5,2,1,4,12,1984610.27815526,7254692.25386221
0,30,0,1,0,4,5,1651088.08099653,3504236.48645601
0,29,2,2,0,6,10,2126180.73287621,6521022.45589533
0,20,2,1,2,3,8,1592185.01315857,7545333.44265734
0,29,6,3,0,2,11,2099650.6863636,8412463.54294972
1,32,0,3,2,3,8,1692565.48899464,2991493.31273292
1,36,0,3,2,4,9,1431209.12780972,8603835.08944416
0,22,1,3,1,2,7,1562483.28713893,4084324.76620905
0,21,2,0,2,6,10,1903499.67157367,9184691.0935397
1,20,3,0,1,3,7,2155388.32525386,9395851.65234265
0,31,6,0,1,2,9,1389266.2603522,6267899.71996526
0,31,5,2,2,6,15,2560854.94843976,6465435.7041916
0,23,4,0,2,6,12,2272729.95938884,7354658.90205167
1,31,2,1,0,6,9,2029475.63663233,8573988.27591617
0,40,5,3,0,1,9,2003064.18703508,4805530.30539067
1,31,1,3,2,0,6,1723232.18066549,5279054.63654499
0,26,0,3,2,2,7,1386728.33059922,3844630.66711007
0,29,5,0,1,5,11,2612661.59751682,7067579.71471232
0,14,4,3,0,6,13,2060225.75544666,7105605.87610477
0,24,3,0,2,5,10,1993990.26463617,3889623.90004068
0,30,6,3,0,1,10,1583225.24056392,6114097.92298334
0,18,6,0,1,6,13,2803361.20370427,4929858.21697504
1,18,3,2,0,5,10,1319653.04893912,6019772.6617167
1,36,0,3,0,2,5,1534712.22700647,5448036.86265319
0,35,2,3,1,1,7,1306502.8779028,2255186.92892763
0,22,6,3,2,2,13,2198470.17838814,5638224.37980247
0,15,3,2,2,1,8,1843109.16358316,5167108.93039634
0,22,3,0,2,4,9,1564038.74830778,6522591.81604967
0,20,5,0,2,6,13,1934616.70731286,9365465.03128925
1,40,5,3,1,5,14,2858972.28276609,7924446.30064815
0,36,2,3,0,3,8,2095790.23784742,3268618.68378143
1,13,3,0,0,1,4,1036932.81669891,4572684.74748043
0,37,3,3,0,6,12,2078774.44035331,6406104.05499092
1,11,6,1,1,4,12,2323543.21964093,3414226.28588883
0,27,1,1,2,3,7,1822184.28579332,2958660.28354973
0,18,2,0,0,1,3,1191869.92533839,2735171.19738253
0,26,5,3,0,6,14,2026400.14431966,9009863.32573243
0,36,6,1,2,2,11,2042545.73215175,7620438.60270771
0,25,5,0,0,1,6,1612737.82715077,4937257.65743055
0,24,5,2,0,6,13,1812028.30990012,6714730.59851635
0,30,2,2,1,3,8,2149127.38463745,4353394.87797891
1,34,5,3,2,4,14,2668364.37221578,3078683.91550947
0,15,2,3,1,5,11,1565208.71457046,9039572.4974225
1,21,3,3,1,1,8,1375995.03783111,3949111.25652249
0,36,5,0,2,6,13,2374222.39937453,8616801.44381503
0,13,3,1,0,2,6,1079952.98131196,5821389.78483041
0,14,5,2,1,3,11,2326626.58404379,3826620.01210531
0,12,6,2,1,7,16,3175108.40094763,1335943.94916575
0,37,0,3,2,6,11,2174590.07015588,6823516.9250349
0,10,5,0,1,4,10,2458441.54595553,7881175.7699323
0,28,2,1,1,3,7,1854867.67535453,7018086.10810435
0,15,2,3,1,6,12,2087490.20786233,6462714.25537833
1,33,6,1,1,1,9,2133513.65306298,3097683.13440099
0,33,3,2,1,1,7,1616092.02153371,5681404.84100857
0,13,0,1,2,2,5,1308581.77523047,5587224.07416334
0,11,1,2,2,1,6,1847586.07334734,4072914.35463861
0,25,1,2,0,7,10,2175058.22884121,5114660.92945527
0,24,2,1,2,5,10,1863618.48847677,6315314.34741442
0,33,2,2,1,3,8,1258175.99959197,4540131.53596844
1,40,1,3,1,2,7,1403254.49353661,4534194.95551432
0,10,0,0,2,7,9,1925756.05262184,3313351.40957964
0,33,3,3,0,3,9,2069499.31051009,5905997.12449219
0,37,6,2,0,0,8,1287713.2724191,3754086.13592972
0,19,6,0,2,0,8,1741627.07572051,6372983.09394557
1,30,2,0,2,4,8,2114625.04518,7336434.60286651
0,38,5,3,1,1,10,2235900.26579788,5510824.67192837
0,17,2,1,0,7,10,1980801.39460441,3247877.85493788
0,18,3,3,1,4,11,1741437.94844826,4225084.7251742
1,27,3,3,1,3,10,1794459.40974003,4608522.30527276
0,39,4,0,1,6,11,2135872.87181307,8457019.35517662
1,29,0,0,2,1,3,1254651.24236983,1922031.49571311
0,17,4,3,2,5,14,2042517.74270747,8469758.44287077
0,12,5,2,1,2,10,2299062.52467173,4415845.46311731
0,15,4,2,2,6,14,1819887.74804737,7559397.40943743
0,31,1,0,0,6,7,1994824.17534581,1681154.74026274
0,12,3,0,2,2,7,1816722.61240066,3399697.32778617
0,14,6,0,2,3,11,2565833.76898725,9154901.40552078
1,33,2,0,0,1,3,1504410.67356099,1759309.75192
0,31,0,0,1,5,6,1332340.11484931,2071505.33477563
0,25,0,2,1,2,5,1560487.36131028,3830650.74538823
1,29,6,1,1,1,9,2006183.37364588,2337987.73383053
0,18,0,2,1,6,9,1867785.12014071,4928375.02586169
1,38,6,2,0,5,13,2333729.33880801,3601963.08119072
0,29,1,0,0,2,3,1528513.32850011,2988197.65652993
1,18,5,3,1,7,16,2826293.83841034,6535751.37388816
1,12,1,1,2,7,11,2566197.44881461,7985985.56200567
0,23,1,0,2,5,8,2251426.20583817,4506246.8095069
0,23,6,2,0,2,10,2347784.49932479,7677756.35973534
0,18,1,1,0,7,9,1821954.99391314,3983257.29487356
1,35,2,0,1,2,5,1265306.16188659,2211129.99518298
1,25,1,0,1,7,9,1583733.59007394,5407996.46176456
1,23,6,3,2,3,14,2446515.64057667,9154445.28660263
0,12,0,0,2,2,4,1520955.27484739,2451947.06089715
1,25,6,1,0,5,12,2027525.66008932,6092739.63432949
1,17,2,2,1,0,5,1768830.82230005,2332011.81241056
0,37,5,0,2,2,9,1946480.0647871,7720322.18719141
0,39,5,2,1,7,15,3194438.9488705,8788039.99439083
0,12,1,2,1,5,9,1764874.04479241,1676467.0114796
0,16,2,1,2,1,6,1326697.99388252,4049289.22166983
0,34,6,3,1,6,16,3092503.95392911,11236465.7589803
1,24,6,2,2,7,17,2551442.2693201,9838118.43135711
1,17,0,1,1,5,7,2137766.82296653,2640070.43725309
1,36,0,3,0,6,9,1230262.14698227,3176084.05702444
0,26,4,0,1,5,10,1705176.33314331,5197865.57938204
0,25,0,2,1,4,7,1994162.69110113,7617304.59683182
0,23,5,2,1,5,13,2315558.45377607,6270058.1638315
1,37,1,2,1,7,11,2397164.71159265,3286609.92240945
0,14,1,1,0,1,3,1309276.42178469,1829591.76123189
0,32,6,3,2,5,16,2449189.04222399,9087545.75500466
0,24,6,2,0,7,15,1845785.22300564,6098951.51907906
1,24,3,0,1,2,6,1085134.3612948,4390434.39734313
0,38,4,0,0,6,10,1468680.75016369,7341915.86871898
0,13,1,0,0,2,3,1451737.77979372,1851022.70952206
1,38,6,3,2,4,15,2261493.2542438,6216297.78257355
0,40,1,2,0,3,6,1981125.03876799,2409946.9159461
0,20,5,2,1,5,13,2754291.6115342,9494292.24131104
1,12,6,1,0,0,7,1554076.45350008,4920757.01407727
1,38,1,0,1,3,5,1273641.80043229,7332738.9837947
1,37,1,3,2,5,11,1878010.45601532,6609702.81504245
0,33,3,0,0,5,8,1965206.28271173,2865299.78139209
0,13,3,3,1,3,10,2220847.86311796,3014932.16060238
0,24,5,0,0,3,8,1968972.89710892,5750881.14077143
0,40,4,1,2,4,11,2161615.98082908,6151803.53663273
0,15,4,3,1,1,9,1691506.4651558,8025741.513559
0,20,4,1,0,3,8,1213571.82279945,4955391.14047561
1,38,4,0,2,5,11,1970422.97368183,6775761.10263736
0,29,2,1,1,3,7,1221259.04905389,5097826.92623032
1,22,2,0,2,3,7,1807689.6919957,5373143.09396687
0,33,5,3,1,7,16,1915413.11963215,7356236.01703002
0,20,6,3,0,5,14,2532052.3810174,5883387.24838624
1,20,0,3,2,5,10,2301717.08540761,5763385.56388349
1,32,1,1,2,7,11,1881437.76950546,8798870.27220093
0,31,5,3,1,6,15,3147492.18498743,8101750.52787014
0,13,5,3,0,3,11,1782555.47541067,4993851.7534122
0,26,6,1,1,4,12,2265052.7802245,5862359.14127492
0,40,5,1,0,4,10,2117377.42002033,6557979.66440298
0,35,5,0,0,6,11,2415985.61845219,5594641.598351
0,30,1,0,0,7,8,1918885.71762499,3856948.40246474
0,15,2,1,0,3,6,1340926.78608801,7257617.87008351
0,10,3,1,2,3,9,2132042.13901575,7554062.19126575
0,28,3,3,2,5,13,2965625.06925077,3360763.16413102
0,39,0,1,0,0,1,1366992.89574573,3826536.36594786
1,12,1,1,2,2,6,1489493.72278205,4401577.59284356
0,36,5,0,2,1,8,1457867.98046072,3919234.38645066
0,19,1,1,0,4,6,1487641.77331976,6368936.54263309
0,20,2,3,2,7,14,2016757.93774839,8096647.62118044
0,25,0,0,0,5,5,1594179.57335298,5219315.56051676
1,27,4,3,1,0,8,1967352.78840168,5967845.71893728
1,31,0,1,0,0,1,988189.084778907,3203669.05984306
1,27,4,3,2,2,11,2033501.38361248,6356874.95081936
1,12,4,0,2,2,8,2048616.24264349,6417860.48743898
0,25,4,3,1,6,14,2546224.33650556,7953816.78287663
1,28,1,3,1,5,10,1714715.70943001,4033157.81559409
0,15,2,3,2,0,7,1721550.00386034,6988304.70286272
1,31,4,0,0,5,9,2163108.3195929,8177613.50737278
1,32,5,0,1,6,12,2858949.64194508,5150422.77240458
0,12,2,1,1,2,6,1639146.2574547,2913650.33400506
0,34,2,1,0,4,7,1708502.4383988,6762698.69119132
0,20,0,0,2,2,4,1447118.50811377,6824523.51805208
0,10,0,2,1,2,5,1552397.32401533,3110037.01884973
0,32,5,3,1,2,11,2157835.89745889,4490956.33814582
0,22,4,1,0,1,6,1931115.92623054,4993035.37251163
1,18,3,0,1,6,10,2128822.14631259,3956001.92117428
0,10,3,0,0,7,10,2754858.23671691,5443493.58315418
0,12,4,2,2,0,8,2164925.37465641,7174518.32853763
0,24,2,3,1,2,8,1346541.30455624,6331991.8094437
0,37,2,0,1,7,10,1843815.04809812,7393643.49235252
0,24,6,3,1,0,10,1550213.99484526,6816851.10542291
0,27,5,3,0,3,11,2343854.92223856,5665339.82183499
1,28,1,0,0,7,8,1648129.08131758,4811272.51502021
1,10,3,0,0,2,5,1332679.80880011,5190546.43338788
0,32,5,1,2,0,8,2212703.62112343,5276369.87892226
0,33,4,0,0,3,7,1371566.67439634,3419459.93362904
0,21,3,3,1,7,14,2168962.61444618,1560902.22716813
0,20,6,0,1,5,12,1727811.81153492,6001207.26647679
1,27,5,2,1,6,14,2795228.16530013,8306028.1195529
0,23,0,1,1,3,5,1296284.17854643,5538311.33682689
